Month-Year,Sales Revenue (₹),Service Fees (₹),Rent (₹),Utilities (₹),Salaries & Wages (₹),Raw Materials / Inventory (₹),Transportation / Logistics (₹),Loan Repayments & Interest (₹),Number of Orders,Customers,Average Order Value,Seasonality_Flag,Fuel Price Index,Total Income (₹),Total Expenses (₹),Net Cash Flow (₹)
2010-01,261701,28648,33629,7917,116666,191015,8669,14979,4139,1761,47.62,0,99.82,290349,372875,-82526
2010-02,494556,39103,22942,6921,189351,134688,11785,25744,3971,2155,97.08,0,129.51,533659,391431,142228
2010-03,315261,37942,39932,5848,106879,128673,24317,27503,4156,612,8.11,1,94.45,353203,333152,20051
2010-04,135521,38768,25318,10896,124381,148913,28668,31652,3474,530,-61.93,1,120.97,174289,369828,-195539
2010-05,421392,48093,37965,7358,87722,212745,29439,27613,3226,3875,163.69,0,120.97,469485,402842,66643
2010-06,227408,38978,36693,12391,146687,128989,14641,19801,3186,3124,123.42,0,146.76,266386,359202,-92816
2010-07,446695,37579,23832,7381,121758,161957,10559,13087,4889,1270,181.71,0,99.31,484274,338574,145700
2010-08,124234,35815,31557,11894,139070,112044,15289,39810,3222,1000,-4.02,1,143.74,160049,349664,-189615
2010-09,135416,12779,39508,7815,133631,124121,21307,35741,2250,1593,-16.26,1,110.47,148195,362123,-213928
2010-10,121108,39269,36838,7115,163984,192645,15101,11183,737,3452,171.44,1,84.98,160377,426866,-266489
2010-11,411894,33621,41227,12172,81380,154352,20457,25224,3912,916,159.68,0,86.74,445515,334812,110703
2010-12,482044,34372,26546,7737,189320,170386,24758,37362,1635,519,337.28,1,120.4,516416,456109,60307
2011-01,210049,20784,23859,9462,82257,74893,12684,5423,4500,2754,104.67,0,140.57,230833,208578,22255
2011-02,125202,40512,47542,7356,114422,169175,21617,22287,3964,317,34.11,0,123.24,165714,382399,-216685
2011-03,372420,17861,24268,7467,117740,170511,6741,27322,3223,2729,120.4,1,95.81,390281,354049,36232
2011-04,115404,38377,22647,14643,196369,81156,5260,23795,4636,1087,-31.15,1,125.6,153781,343870,-190089
2011-05,359888,25676,44066,11999,153559,121175,17241,10546,2266,2979,221.99,0,92.62,385564,358586,26978
2011-06,158015,34920,41239,7616,182712,109195,24300,32776,783,1536,216.64,0,102.49,192935,397838,-204903
2011-07,251228,41577,33697,5881,161407,126121,10068,18365,1158,2459,189.7,0,135.74,292805,355539,-62734
2011-08,493178,26286,38895,13552,118398,73196,7791,30280,2766,3679,251.7,1,80.43,519464,282112,237352
2011-09,119108,28252,29429,5321,95398,125267,22189,26055,2189,3809,90.75,1,137.52,147360,303659,-156299
2011-10,258911,30649,46568,8419,195258,234294,17326,34179,2034,1823,74.56,1,84.45,289560,536044,-246484
2011-11,220011,23311,28345,13447,183786,193918,16855,19888,3254,3867,115.35,0,110.54,243322,456239,-212917
2011-12,254046,33294,37612,7531,144671,57562,10999,23536,2679,2049,105.99,1,129.6,287340,281911,5429
2012-01,458585,21481,26883,14868,100475,195894,28553,18914,687,3045,717.31,0,101.04,480066,385587,94479
2012-02,411233,45034,25083,6671,125517,236226,13213,12460,3800,2059,99.58,0,99.52,456267,419170,37097
2012-03,124432,27295,40572,7686,177780,62479,19629,15399,1224,3794,111.47,1,133.45,151727,323545,-171818
2012-04,266048,26399,49388,12196,119313,212089,24703,37949,4858,3083,76.86,1,128.73,292447,455638,-163191
2012-05,195196,29991,42572,12458,91677,131381,8434,21782,1030,2205,160.83,0,113.43,225187,308304,-83117
2012-06,112561,44224,34177,9173,85431,159990,7461,19156,1284,2971,86.59,0,144.25,156785,315388,-158603
2012-07,202393,32852,25882,10245,124828,194659,5154,22144,4143,2546,40.1,0,109.43,235245,382912,-147667
2012-08,105663,15740,30038,13702,119069,151774,28151,38197,1587,2928,152.66,1,146.41,121403,380931,-259528
2012-09,324035,40377,28548,7623,126687,245308,8821,17663,1071,3394,353.11,1,137.12,364412,434650,-70238
2012-10,326349,37452,49795,10029,171551,193348,24411,26747,4401,2791,67.32,1,123.2,363801,475881,-112080
2012-11,267260,21107,22747,5853,199379,167801,23097,28358,2097,1895,122.45,0,89.67,288367,447235,-158868
2012-12,498730,45841,37499,11405,119262,50699,22817,7380,4847,2658,71.01,1,144.9,544571,249062,295509
2013-01,481657,16110,32329,5448,184043,89013,18335,31324,1507,2647,366.81,0,118.02,497767,360492,137275
2013-02,327077,32002,25931,6930,86447,183648,20226,36915,4426,2441,153.88,0,143.16,359079,360097,-1018
2013-03,335063,22631,40929,8097,81798,204091,24968,23061,1341,1549,168.62,1,147.49,357694,382944,-25250
2013-04,396563,30288,41095,10801,178847,194549,9058,37865,4855,726,98.13,1,86.61,426851,472215,-45364
2013-05,106440,20752,32044,6431,117010,50224,26417,35928,3073,813,15.72,0,96.59,127192,268054,-140862
2013-06,372537,30577,25514,13950,147740,190410,28563,22288,3517,3159,9.47,0,96.78,403114,428465,-25351
2013-07,333673,49136,39158,8540,174154,65185,18545,7334,4148,854,89.66,0,95.11,382809,312916,69893
2013-08,322507,28098,34019,8177,92976,82421,26621,31074,1185,1495,245.76,1,127.15,350605,275288,75317
2013-09,223147,26114,33213,13388,111565,108920,14108,13899,1906,2709,102.91,1,117.4,249261,295093,-45832
2013-10,107471,35909,39126,8353,110613,232243,6622,20023,582,3857,206.18,1,148.45,143380,416980,-273600
2013-11,399124,28056,25929,12316,84701,131135,24327,32384,2953,532,150.28,0,117.37,427180,310792,116388
2013-12,191154,45320,27863,8643,158240,104111,28826,11599,4506,1205,-101.82,1,138.63,236474,339282,-102808
2014-01,111422,31156,47479,6416,146516,240700,22024,14145,3098,2429,84.78,0,118.59,142578,477280,-334702
2014-02,289982,40250,49099,12441,111341,108499,25225,18490,2955,327,113.05,0,87.93,330232,325095,5137
2014-03,416030,41631,40429,14456,157740,172553,27263,19994,4236,1316,166.39,1,97.01,457661,432435,25226
2014-04,352389,43925,41595,13020,97601,242480,23840,11984,3301,3121,132.1,1,115.11,396314,430520,-34206
2014-05,144635,44079,49517,14585,183030,164123,18221,12937,2846,3723,48.31,0,145.94,188714,442413,-253699
2014-06,459703,46872,21084,10347,152850,207368,18971,23215,2712,3165,174.94,0,125.06,506575,433835,72740
2014-07,352802,38542,33568,5264,140326,184299,24535,26588,3317,2833,69.31,0,107.95,391344,414580,-23236
2014-08,290966,14861,23483,9423,129607,224363,29339,31179,708,717,339.87,1,94.86,305827,447394,-141567
2014-09,159119,25480,34833,11227,184057,168598,17663,9967,1689,2015,174.15,1,112.81,184599,426345,-241746
2014-10,268973,42269,27821,10233,141122,114257,29463,31254,3373,1695,32.15,1,144.8,311242,354150,-42908
2014-11,249108,13356,39314,14089,143647,201368,21798,37644,3618,2010,72.9,0,81.61,262464,457860,-195396
2014-12,223472,15802,49033,8531,117582,108595,19952,23307,1856,3918,131.08,1,147.36,239274,327000,-87726
2015-01,202785,44348,28869,8582,187863,115462,25105,16010,670,3039,293.44,0,82.46,247133,381891,-134758
2015-02,278716,10750,31610,6078,191947,162971,6789,10582,530,1484,581.21,0,95.5,289466,409977,-120511
2015-03,190343,21752,25772,6168,141519,223842,14466,26700,3903,3812,51.39,1,142.84,212095,438467,-226372
2015-04,272920,13113,34778,12244,143740,104681,22046,38330,896,2542,234.5,1,89.99,286033,355819,-69786
2015-05,285410,38325,48091,12297,89293,171356,12813,7908,4095,3348,134.7,0,138.85,323735,341758,-18023
2015-06,181849,38844,40647,7859,110173,195341,15867,27039,4489,1040,-67.61,0,87.5,220693,396926,-176233
2015-07,287521,10600,46618,6347,175881,50080,19384,35721,2123,3179,162.36,0,105.21,298121,334031,-35910
2015-08,254454,32273,22578,6162,93547,226898,20131,9399,1840,3732,180.89,1,82.4,286727,378715,-91988
2015-09,405375,46146,42995,10560,178816,156440,16243,5996,4714,2504,136.01,1,91.79,451521,411050,40471
2015-10,327625,37925,22000,12961,168346,131249,26235,34163,4361,3727,52.2,1,125.63,365550,394954,-29404
2015-11,257305,21565,30276,11721,197287,138348,28689,15299,3914,2582,-63.4,0,83.17,278870,421620,-142750
2015-12,261626,37164,43761,9525,142902,99583,16128,14489,1345,507,176.17,1,127.61,298790,326388,-27598
2016-01,214792,27088,49250,10802,110196,152423,20475,21719,4439,2023,82.03,0,122.83,241880,364865,-122985
2016-02,389115,20821,41162,6805,80891,126662,23032,25930,4149,1653,165.65,0,121.07,409936,304482,105454
2016-03,423870,39703,27108,5292,173363,120244,23963,13258,1125,1800,418.93,1,130.03,463573,363228,100345
2016-04,433462,32769,28997,13739,107552,225311,8402,33505,1306,2970,305.09,1,95.05,466231,417506,48725
2016-05,258092,25665,21275,12451,89531,101383,15243,29731,4119,1799,69.07,0,124.26,283757,269614,14143
2016-06,435074,46340,38500,5844,171707,172980,29883,13478,4514,867,140.07,0,135.08,481414,432392,49022
2016-07,228131,25331,42317,7120,138392,102305,8739,25100,2012,3127,80.69,0,136.26,253462,323973,-70511
2016-08,201871,43347,28478,12518,85343,141912,6449,31748,550,2466,376.21,1,106.74,245218,306448,-61230
2016-09,242693,29147,33006,13278,180557,150965,11905,33832,2922,1485,142.12,1,84.53,271840,423543,-151703
2016-10,485718,36877,44942,6407,197062,211703,13360,15753,4901,2506,-41.87,1,128.93,522595,489227,33368
2016-11,211388,36464,23752,13458,163355,235015,16351,23092,3567,2063,5.66,0,115.94,247852,475023,-227171
2016-12,269485,15215,20588,6611,117312,239326,29036,38161,2758,3008,171.7,1,104.74,284700,451034,-166334
2017-01,119515,39778,33249,5064,194353,104532,8529,30602,4883,424,60.46,0,89.64,159293,376329,-217036
2017-02,406344,45347,23870,5756,128276,68589,21650,16928,2090,3728,182.93,0,92.48,451691,265069,186622
2017-03,258675,49278,30770,13066,92003,62513,11021,26348,4848,1937,55.93,1,128.47,307953,235721,72232
2017-04,117582,34206,49446,12480,101559,69551,22377,22536,3122,3003,-38.91,1,120.37,151788,277949,-126161
2017-05,280859,20200,40144,7763,96022,177550,8166,19564,1205,1825,198.87,0,122.28,301059,349209,-48150
2017-06,344748,32603,39958,6052,177034,118042,23604,12150,1128,892,326.71,0,111.67,377351,376840,511
2017-07,117049,37718,42444,14226,111953,220055,11423,37083,2024,2249,8.44,0,99.49,154767,437184,-282417
2017-08,283621,36355,42675,11818,167745,147340,23659,25043,2535,1914,4.95,1,120.79,319976,418280,-98304
2017-09,143026,36549,25581,6857,80131,78567,10864,14995,2130,1889,184.44,1,105.98,179575,216995,-37420
2017-10,424427,34244,45258,11988,168103,97252,9068,24002,4554,3978,129.7,1,113.06,458671,355671,103000
2017-11,335678,21830,45520,8766,128725,191379,7716,35912,4778,2643,149.34,0,149.76,357508,418018,-60510
2017-12,197724,32919,34435,5704,179703,164478,16258,26417,1012,1228,196.19,1,99.13,230643,426995,-196352
2018-01,175656,15353,23539,8970,151884,127338,7127,8377,2466,1560,34.4,0,107.26,191009,327235,-136226
2018-02,277892,33088,32618,11076,191349,94335,5122,23045,3814,2445,133.91,0,139.81,310980,357545,-46565
2018-03,375104,33301,23220,11763,179227,158978,18509,12569,4187,1307,139.56,1,141.48,408405,404266,4139
2018-04,363826,43289,26041,9076,123456,120483,22596,33774,2504,2107,114.24,1,114.39,407115,335426,71689
2018-05,445468,19010,48326,5672,109002,105703,9320,21008,3975,2306,19.42,0,117.4,464478,299031,165447
2018-06,481238,22017,31467,6864,150638,216085,8280,22837,1531,1879,300.82,0,81.81,503255,436171,67084
2018-07,150639,43446,35320,12828,91613,218008,5053,13435,4860,1616,18.68,0,124.51,194085,376257,-182172
2018-08,217488,24796,45042,8819,107749,87776,14037,29840,642,948,324.09,1,135.38,242284,293263,-50979
2018-09,285399,23978,49886,5400,101477,209951,16945,22262,1680,1729,236.5,1,126.23,309377,405921,-96544
2018-10,275518,43704,40255,9337,89018,213010,14632,29571,3529,1325,20.29,1,84.64,319222,395823,-76601
2018-11,212604,26611,25707,14420,108696,176545,23341,23762,3019,961,136.44,0,138.46,239215,372471,-133256
2018-12,162786,20267,28221,10015,144094,237304,10224,13597,645,2050,212.84,1,129.81,183053,443455,-260402
2019-01,167935,17527,45587,5653,88265,243677,27459,23995,1528,3504,146.99,0,87.22,185462,434636,-249174
2019-02,208382,19171,28091,10911,86062,235086,25125,29533,1019,2660,203.51,0,143.68,227553,414808,-187255
2019-03,410456,20835,20112,12937,173675,202034,12005,27874,969,1691,441.3,1,84.05,431291,448637,-17346
2019-04,474136,29876,49950,13679,170308,82111,25737,6488,971,1194,544.18,1,102.62,504012,348273,155739
2019-05,349542,48028,28924,13979,123082,202527,6338,18842,2425,2659,163.58,0,98.3,397570,393692,3878
2019-06,250369,26461,39083,10495,157257,190598,17761,25738,996,635,272.98,0,126.44,276830,440932,-164102
2019-07,417628,11570,49304,11804,128321,194072,5480,27734,3545,2244,102.29,0,125.92,429198,416715,12483
2019-08,377699,22711,45300,14829,176025,136259,12644,29946,4613,2000,-1.44,1,106.54,400410,415003,-14593
2019-09,372730,23028,41679,11907,190622,170145,17543,17445,1168,1087,328.02,1,104.14,395758,449341,-53583
2019-10,333777,32209,26910,11417,116917,239331,24438,38523,4495,868,148.3,1,118.44,365986,457536,-91550
2019-11,475806,29973,22020,9692,142865,140965,8865,32545,4570,798,70.61,0,143.19,505779,356952,148827
2019-12,298235,46885,22738,7734,156439,247277,9074,20180,1834,2375,102.66,1,86.8,345120,463442,-118322
2020-01,334423,29694,23595,11852,95579,169736,5227,23570,866,1508,381.42,0,113.43,364117,329559,34558
2020-02,368706,27730,34591,7706,187453,50392,14363,16975,2903,1340,211.95,0,97.03,396436,311480,84956
2020-03,305718,31345,28599,7265,189311,135757,18505,32069,1274,2749,327.61,1,147.45,337063,411506,-74443
2020-04,248799,19476,20101,9608,183274,168918,25844,23511,1812,1771,168.84,1,93.3,268275,431256,-162981
2020-05,181588,46896,47373,5476,122004,193226,24655,38160,2450,3309,92.05,0,134.28,228484,430894,-202410
2020-06,198123,36874,31694,13376,150088,192188,19262,20085,3188,1587,29.36,0,123.53,234997,426693,-191696
2020-07,473954,35964,24343,11318,181894,149750,7407,21139,3847,2735,125.48,0,111.54,509918,395851,114067
2020-08,486544,25264,49716,11167,196748,89741,22349,35225,3112,1217,265.9,1,138.54,511808,404946,106862
2020-09,327703,49438,31618,13596,195435,105474,12466,23002,3156,3590,156.25,1,82.72,377141,381591,-4450
2020-10,444259,21321,39162,8942,81322,154341,28225,29797,3872,3103,129.41,1,149.57,465580,341789,123791
2020-11,330526,11703,26576,8480,128471,98174,23305,28143,4753,3163,95.61,0,111.55,342229,313149,29080
2020-12,233200,34906,23018,9380,170399,66279,9856,32687,4977,1203,36.32,1,119.35,268106,311619,-43513
2021-01,412826,42299,20952,12167,195099,91826,13024,38785,4819,975,97.67,0,94.57,455125,371853,83272
2021-02,303434,22862,39832,9088,92182,142525,24403,7130,1894,887,167.84,0,113.93,326296,315160,11136
2021-03,275221,31208,48704,6884,143877,103940,20489,8850,975,2041,230.43,1,88.64,306429,332744,-26315
2021-04,430265,46672,22127,12294,166938,100728,7156,19002,4954,2365,1.97,1,140.38,476937,328245,148692
2021-05,494358,33520,20526,11834,109775,216118,24397,9801,2668,2589,280.77,0,86.91,527878,392451,135427
2021-06,444482,13379,34314,13972,112038,110883,22340,20613,1110,1033,348.36,0,132.4,457861,314160,143701
2021-07,242657,20578,43017,7588,125315,81430,27264,33500,1659,1519,213.88,0,108.29,263235,318114,-54879
2021-08,290487,35680,20119,9680,190910,65998,25201,29215,2937,3540,102.09,1,106.83,326167,341123,-14956
2021-09,432557,37804,26132,12739,132242,153127,27722,17202,2345,3910,173.65,1,134.41,470361,369164,101197
2021-10,235851,40698,23013,13748,184184,179169,29024,33083,1244,355,184.56,1,110.95,276549,462221,-185672
2021-11,129772,46209,29846,14149,92043,239048,11698,33135,4536,2777,118.01,0,123.82,175981,419919,-243938
2021-12,449781,24828,47803,11198,92531,113911,28146,7886,990,2523,444.28,1,89.09,474609,301475,173134
2022-01,417836,16043,33255,7455,163365,227320,27007,27795,3396,1877,1.9,0,93.18,433879,486197,-52318
2022-02,255537,32706,39934,11693,119581,137494,15321,13229,3373,661,93.99,0,96.99,288243,337252,-49009
2022-03,291344,10098,39474,11131,121251,144343,19429,13464,885,1427,317.18,1,138.12,301442,349092,-47650
2022-04,305048,40684,30595,12811,121105,50195,26592,23188,996,2430,266.76,1,106.13,345732,264486,81246
2022-05,393351,10531,38969,11059,189555,160538,9324,30894,3132,3281,102.95,0,142.83,403882,440339,-36457
2022-06,151791,11386,20980,8282,149074,80156,27376,13029,4335,2686,23.82,0,89.19,163177,298897,-135720
2022-07,296934,48178,25635,12631,148226,104807,13006,25843,3346,1701,46.79,0,87.15,345112,330148,14964
2022-08,362352,21463,43507,8687,199728,232481,28689,30755,3103,2404,222.39,1,83.71,383815,543847,-160032
2022-09,250025,30208,22061,14267,87879,62298,6056,32812,4294,1025,108.07,1,99.06,280233,225373,54860
2022-10,424532,13844,25814,5439,106301,199767,13867,9463,2800,379,211.86,1,81.25,438376,360651,77725
2022-11,372862,38752,41140,10736,145427,168674,13805,24568,1390,2522,219.36,0,147.29,411614,404350,7264
2022-12,437711,11341,48259,11559,101586,192038,11223,38628,1544,3325,295.15,1,125.89,449052,403293,45759
2023-01,363683,21259,46589,12915,182964,127339,24656,18017,1659,2299,203.8,0,140.98,384942,412480,-27538
2023-02,289354,26751,31356,13506,167499,72339,25215,12398,2573,691,159.88,0,88.0,316105,322313,-6208
2023-03,215781,21559,31237,12594,171348,140281,8080,34806,4892,661,78.37,1,123.98,237340,398346,-161006
2023-04,272857,36327,34683,9319,149435,191581,10957,30296,2917,2630,67.56,1,125.57,309184,426271,-117087
2023-05,446371,34534,28658,13781,197021,171554,20409,17418,4065,2715,108.75,0,117.57,480905,448841,32064
2023-06,485341,27660,31269,5446,196056,69174,12285,10985,4111,1787,121.84,0,136.11,513001,325215,187786
2023-07,285786,19435,29248,6787,98467,127097,27749,29272,4744,1821,35.39,0,131.66,305221,318620,-13399
2023-08,130984,32640,21913,5133,107825,196687,13886,29324,2753,2638,-5.28,1,83.63,163624,374768,-211144
2023-09,445009,20914,20747,9598,161236,245825,25633,30192,3522,1413,156.36,1,100.02,465923,493231,-27308
2023-10,270171,26595,20457,6546,163247,204692,21558,23564,742,1194,372.6,1,111.58,296766,440064,-143298
2023-11,156838,21591,27949,13349,141682,154078,15648,23007,3256,3048,-3.72,0,103.3,178429,375713,-197284
2023-12,288506,38057,36046,7048,193042,154145,16832,14576,4721,1212,39.95,1,88.51,326563,421689,-95126
2024-01,119889,16141,40909,12445,144050,190335,28672,5949,794,2987,117.13,0,139.58,136030,422360,-286330
2024-02,157620,12585,46632,13313,152841,120870,5095,37071,2609,3153,126.24,0,129.99,170205,375822,-205617
2024-03,146006,40690,43482,13824,187762,244500,21287,14904,749,1612,251.03,1,144.22,186696,525759,-339063
2024-04,127015,37785,30855,12892,186608,156458,15701,32550,2893,3969,8.67,1,147.28,164800,435064,-270264
2024-05,301255,25257,41511,6592,149755,57732,10546,34124,4753,2702,31.83,0,102.22,326512,300260,26252
2024-06,281778,22906,22544,9712,117081,220605,17046,25196,3756,3152,49.44,0,117.15,304684,412184,-107500
2024-07,477833,38096,25972,13890,119976,76250,20630,34266,3432,2491,112.19,0,116.62,515929,290984,224945
2024-08,353969,32328,26225,14932,92131,108467,28582,13411,3298,463,-0.67,1,124.06,386297,283748,102549
2024-09,402528,36505,33539,14841,147382,66468,22710,9248,623,1704,681.84,1,129.93,439033,294188,144845
2024-10,460432,35429,27546,13218,173374,218668,27155,11450,2666,3377,205.7,1,102.32,495861,471411,24450
2024-11,170984,22975,31564,8543,140062,203032,21599,17784,4660,2209,3.79,0,146.36,193959,422584,-228625
2024-12,147680,25629,39558,6695,99963,249575,5329,18159,3674,3260,42.12,1,144.24,173309,419279,-245970
2025-01,129229,41852,22613,6817,104642,188007,10356,9290,2895,722,69.85,0,134.88,171081,341725,-170644
2025-02,468864,12187,47766,6187,86003,51792,8471,30393,3010,549,181.11,0,140.92,481051,230612,250439
2025-03,478386,13611,36534,13961,103315,114975,21959,39050,2007,451,220.5,1,125.82,491997,329794,162203
2025-04,421878,11016,34073,10526,185931,126041,24748,26571,4253,1878,66.66,1,119.7,432894,407890,25004
2025-05,137835,33825,44334,13507,188563,231162,18987,33559,2140,1742,55.7,0,127.55,171660,530112,-358452
2025-06,468698,32537,32481,6953,161827,186823,6081,21806,902,365,533.74,0,136.95,501235,415971,85264
2025-07,342610,30451,22126,5678,103776,184132,21549,22073,2515,708,237.51,0,136.98,373061,359334,13727
2025-08,477100,37354,37178,14333,125579,227869,25470,8464,3850,1533,154.77,1,135.39,514454,438893,75561
2025-09,307685,17733,43721,7977,111166,215500,29301,19258,3308,1250,37.43,1,113.15,325418,426923,-101505
2025-10,313618,28235,24530,14485,196477,177582,17964,17297,1919,3426,224.57,1,129.39,341853,448335,-106482
2025-11,460229,22315,26151,13048,108444,189729,9152,13538,2885,3456,213.39,0,90.75,482544,360062,122482
2025-12,449616,29365,30133,5022,89531,163217,12765,32318,4768,751,116.92,1,134.91,478981,332986,145995
2026-01,135667,20289,31936,13275,80230,240012,14728,7142,2009,3210,142.4,0,115.78,155956,387323,-231367
2026-02,236212,36451,30900,10176,89611,66988,9719,39239,4432,2215,110.48,0,112.99,272663,246633,26030
2026-03,142077,25415,45833,9630,187629,174068,14331,24631,3567,1844,80.31,1,80.84,167492,456122,-288630
2026-04,349212,18787,41651,14134,134512,106659,9916,15295,4833,2368,41.84,1,98.33,367999,322167,45832
2026-05,341433,46214,29272,11004,136339,192886,8594,36334,3936,2251,71.16,0,91.45,387647,414429,-26782
2026-06,424206,10986,22140,12346,90899,71786,8562,29331,1847,1675,361.94,0,109.71,435192,235064,200128
2026-07,154486,42894,33333,8284,173453,78032,24975,10123,2130,1407,133.03,0,90.2,197380,328200,-130820
2026-08,337074,19647,25021,10273,199762,173006,15555,14825,1754,1020,282.28,1,102.06,356721,438442,-81721
2026-09,389796,18707,25197,9676,191709,138261,5164,6329,1362,3132,241.3,1,103.56,408503,376336,32167
2026-10,375969,34079,36932,6864,80165,173588,20244,28797,4621,3136,131.52,1,141.59,410048,346590,63458
2026-11,450147,34212,41371,10936,176975,198771,28615,19145,1664,3802,249.24,0,96.79,484359,475813,8546
2026-12,396718,22973,24907,14632,102032,98012,9798,17629,2486,2731,185.86,1,123.22,419691,267010,152681
2027-01,421205,46710,32905,7396,100508,221929,17622,29197,3952,644,48.11,0,105.75,467915,409557,58358
2027-02,193615,38682,23117,9997,95000,63478,12762,11248,4633,2333,1.46,0,89.45,232297,215602,16695
2027-03,286785,17019,30924,10774,178102,124964,20814,9869,4259,2228,-33.11,1,121.32,303804,375447,-71643
2027-04,233461,33677,36277,13195,155489,180222,27040,14948,3800,958,-39.65,1,96.77,267138,427171,-160033
2027-05,318277,18160,31332,13218,89489,165376,26971,21282,3720,3267,139.51,0,116.64,336437,347668,-11231
2027-06,201071,21302,29884,11260,98363,246147,12846,13581,4580,2507,128.02,0,142.77,222373,412081,-189708
2027-07,333297,25934,27953,13833,124493,190719,14116,16249,3852,3724,85.88,0,141.51,359231,387363,-28132
2027-08,458889,39695,40407,8466,82661,180876,14318,31700,580,1465,837.96,1,96.41,498584,358428,140156
2027-09,266966,14506,24356,14449,173245,91003,29953,17961,3134,530,71.94,1,132.36,281472,350967,-69495
2027-10,283711,10187,31750,12327,137555,170020,22537,35248,2453,1382,121.71,1,127.34,293898,409437,-115539
2027-11,380999,43745,49463,12808,198018,119284,15811,31713,2790,3944,187.24,0,81.4,424744,427097,-2353
2027-12,183440,48922,35627,11140,98042,158006,6258,22045,2754,591,108.29,1,145.67,232362,331118,-98756
2028-01,372005,18902,24185,14946,162150,220135,14929,32518,1633,1533,262.64,0,99.72,390907,468863,-77956
2028-02,407164,42083,28221,10627,166991,149173,24871,34917,1995,1063,249.49,0,93.65,449247,414800,34447
2028-03,431188,16706,30394,13434,109935,144237,28149,31762,2394,3901,210.49,1,149.54,447894,357911,89983
2028-04,162552,43137,23115,8118,156634,102315,8064,22251,1160,2462,195.64,1,148.08,205689,320497,-114808
2028-05,295515,49654,31024,7660,84595,172666,28186,32835,3659,2908,68.1,0,121.46,345169,356966,-11797
2028-06,155029,27109,30227,11691,166409,150397,8609,14584,1738,2015,81.75,0,136.58,182138,381917,-199779
2028-07,104856,45132,42166,7352,147357,190429,7728,23294,2610,3566,74.86,0,148.5,149988,418326,-268338
2028-08,317726,23094,42382,9194,152493,118421,6284,12088,559,1921,612.87,1,109.49,340820,340862,-42
2028-09,298138,12519,26182,10196,87186,121205,12072,9033,3062,2285,29.67,1,92.34,310657,265874,44783
2028-10,161439,25068,33217,8563,171779,193074,26121,38073,1772,2786,89.76,1,126.33,186507,470827,-284320
2028-11,297819,41559,43206,12055,135085,118371,13693,24928,2336,2524,101.56,0,98.42,339378,347338,-7960
2028-12,393287,21623,28150,10721,157551,164351,13936,17023,2638,3524,197.9,1,100.52,414910,391732,23178
2029-01,187056,18043,31284,9774,164716,112657,5336,10977,982,2356,151.93,0,134.06,205099,334744,-129645
2029-02,426341,38870,47014,7553,94061,173198,14640,5971,1387,1175,352.78,0,96.12,465211,342437,122774
2029-03,458567,28919,24349,5174,89341,76421,25882,27693,3253,664,110.79,1,105.26,487486,248860,238626
2029-04,415903,33229,37756,8165,155467,129742,6411,36581,1223,962,266.93,1,131.76,449132,374122,75010
2029-05,233183,42105,20600,14425,81054,158486,27820,25811,4255,3376,-17.54,0,130.93,275288,328196,-52908
2029-06,162967,12694,28084,8148,125995,222249,27962,18039,4722,2042,73.18,0,132.94,175661,430477,-254816
2029-07,166588,31526,22191,9238,114208,243728,26294,5298,1348,733,186.26,0,97.26,198114,420957,-222843
2029-08,487034,36596,43616,10243,83498,77277,15271,27201,4462,2557,92.44,1,109.64,523630,257106,266524
2029-09,112267,46838,46677,11996,115005,107230,27979,14595,2549,3111,36.28,1,125.79,159105,323482,-164377
2029-10,141472,36268,22980,14087,89426,212163,19757,30080,751,1650,231.07,1,125.54,177740,388493,-210753
2029-11,256056,27142,38867,12488,175904,134248,23427,32931,2184,841,107.46,0,132.88,283198,417865,-134667
2029-12,496545,15974,20586,11396,122668,125300,15315,39140,3934,890,90.56,1,81.22,512519,334405,178114
2030-01,231289,14640,44458,10516,172582,118820,7715,30101,3023,1933,27.02,0,137.97,245929,384192,-138263
2030-02,126784,14077,26160,11977,108876,178277,18306,36629,1484,2411,167.32,0,145.14,140861,380225,-239364
2030-03,421473,41154,44316,8335,103929,195394,24910,9119,2151,330,138.56,1,144.8,462627,386003,76624
2030-04,337160,17083,24146,11325,180673,215591,16325,15697,580,1160,601.72,1,94.0,354243,463757,-109514
2030-05,350252,40208,30774,5304,118620,213752,9527,9859,4336,1576,138.8,0,143.79,390460,387836,2624
2030-06,339505,36248,23439,9037,170082,85059,11138,19303,2708,859,136.69,0,120.01,375753,318058,57695
2030-07,238722,10471,26668,10762,93037,197294,11082,29518,4057,3514,42.11,0,109.91,249193,368361,-119168
2030-08,346220,42187,25665,6947,101641,134765,23223,21523,2424,533,286.68,1,112.99,388407,313764,74643
2030-09,379954,42935,29746,6577,174361,241410,19417,7599,2219,3677,135.09,1,146.32,422889,479110,-56221
2030-10,232077,28902,32252,9140,80562,237558,15831,30575,4837,2156,61.61,1,114.4,260979,405918,-144939
2030-11,464272,28664,37192,10056,125771,74487,11847,34294,1507,3786,328.06,0,135.34,492936,293647,199289
2030-12,323453,25755,30185,5463,137712,92097,15201,11305,2705,3320,193.61,1,88.42,349208,291963,57245
2031-01,321885,47360,38478,13466,137086,227539,19597,11853,588,2117,564.75,0,124.7,369245,448019,-78774
2031-02,456804,13077,45895,9432,134713,53913,17561,34305,694,2010,680.87,0,85.28,469881,295819,174062
2031-03,174186,17221,49405,9167,98123,233087,12421,37491,4885,1031,51.03,1,109.15,191407,439694,-248287
2031-04,455750,18128,41664,9959,101193,212404,11430,9626,2941,1325,239.36,1,136.38,473878,386276,87602
2031-05,434261,12537,37098,10974,91365,148858,22539,28380,3289,921,81.93,0,104.42,446798,339214,107584
2031-06,378881,24340,37153,5834,102936,74747,27887,13809,1987,340,188.19,0,83.91,403221,262366,140855
2031-07,353102,30450,41057,7817,134996,126756,5451,11348,1050,1382,296.31,0,84.24,383552,327425,56127
2031-08,338981,32839,40213,8022,151056,182844,5112,39471,1200,3862,294.37,1,85.74,371820,426718,-54898
2031-09,384484,41109,43198,10018,152914,177312,9799,8998,2206,610,198.89,1,113.27,425593,402239,23354
2031-10,302822,32038,27954,13654,103826,201278,17133,20010,788,2786,367.14,1,115.09,334860,383855,-48995
2031-11,264584,38087,49416,9964,105460,70636,8702,19498,3168,2230,124.6,0,135.92,302671,263676,38995
2031-12,487754,20226,29369,6213,166807,191985,24545,32574,501,3055,854.35,1,103.15,507980,451493,56487
2032-01,266994,27926,37469,13972,145675,149469,12801,13015,1814,2221,98.77,0,112.93,294920,372401,-77481
2032-02,150916,44770,37111,12057,118090,184746,24238,10706,2841,2627,24.07,0,126.3,195686,386948,-191262
2032-03,341216,19685,39197,10312,120392,94185,25062,13393,3405,3849,33.46,1,135.38,360901,302541,58360
2032-04,281680,38937,39500,11438,109305,151580,28628,28595,1424,2350,233.1,1,131.99,320617,369046,-48429
2032-05,123258,49283,28738,6808,134106,134650,28094,22582,3738,3699,9.19,0,120.99,172541,354978,-182437
2032-06,394461,48456,39390,10039,193198,77965,20632,6782,2243,1649,193.86,0,87.16,442917,348006,94911
2032-07,447992,40238,27885,8336,198796,227707,5496,19499,2498,1034,112.76,0,132.61,488230,487719,511
2032-08,205732,35916,34190,5815,107554,136053,19171,36907,4124,302,89.04,1,99.74,241648,339690,-98042
2032-09,449221,12593,33776,7193,127886,249190,24057,10000,4764,3925,129.31,1,122.12,461814,452102,9712
2032-10,463303,41530,46653,9519,86029,140181,20425,13598,1818,2641,174.18,1,91.91,504833,316405,188428
2032-11,247990,16192,44855,8181,147866,172092,12477,35820,3834,1693,-0.31,0,147.85,264182,421291,-157109
2032-12,204992,38122,39803,12631,163058,145992,14439,6578,3580,2345,94.13,1,95.29,243114,382501,-139387
2033-01,145980,10445,46259,10623,184117,207701,19373,12176,1668,3308,64.73,0,83.77,156425,480249,-323824
2033-02,377377,38810,42466,11747,190287,99754,5462,17063,2259,1811,62.4,0,92.33,416187,366779,49408
2033-03,400884,16001,33080,14326,198805,236312,22737,36392,2259,3988,122.53,1,115.72,416885,541652,-124767
2033-04,199073,41071,46067,6986,127750,140729,29118,13645,2213,2654,-16.95,1,92.89,240144,364295,-124151
2033-05,486692,40098,23365,14168,125925,88684,24003,25021,4308,2614,124.93,0,119.17,526790,301166,225624
2033-06,308108,30678,46319,5025,189702,195097,15015,33382,4960,2317,46.71,0,96.87,338786,484540,-145754
2033-07,350864,10895,48639,12838,81259,177873,18433,28619,4317,2502,66.78,0,125.3,361759,367661,-5902
2033-08,384950,18274,25536,13554,115061,220337,21073,22638,3204,2543,38.79,1,96.1,403224,418199,-14975
2033-09,385858,11810,44671,13763,160433,180349,6334,15604,3604,2893,95.84,1,119.84,397668,421154,-23486
2033-10,176126,18513,24200,12165,173458,68260,17170,5936,4566,3265,19.88,1,80.29,194639,301189,-106550
2033-11,231952,25988,45288,9248,98757,226257,25706,6869,3476,1594,25.81,0,141.35,257940,412125,-154185
2033-12,487460,47436,49756,12612,180757,141409,23906,32803,1102,1160,496.22,1,118.48,534896,441243,93653
2034-01,412790,21508,31029,12428,178704,166702,13392,38439,1091,3134,380.14,0,127.51,434298,440694,-6396
2034-02,153309,11233,35564,14511,187836,80499,17844,9189,4660,3359,36.29,0,93.05,164542,345443,-180901
2034-03,209362,16624,26643,9642,91909,97423,27106,27741,3248,1777,67.17,1,118.45,225986,280464,-54478
2034-04,212782,15846,22894,14859,132232,63962,10443,29035,3815,1263,31.08,1,106.4,228628,273425,-44797
2034-05,464998,19055,34651,7368,146410,220315,5492,26293,3603,2564,69.96,0,134.08,484053,440529,43524
2034-06,176215,39179,46593,14383,112683,206218,25183,19768,1874,2263,91.84,0,125.01,215394,424828,-209434
2034-07,214413,48189,33903,9849,99161,218358,12978,36832,2989,1210,136.8,0,95.45,262602,411081,-148479
2034-08,358321,44090,46493,12359,183957,101122,14927,26591,3691,3856,106.67,1,119.28,402411,385449,16962
2034-09,112777,14514,48911,14009,179104,142855,16436,7935,541,1682,239.86,1,93.74,127291,409250,-281959
2034-10,270205,15211,40277,7432,184051,76157,11889,6881,3388,707,19.91,1,86.39,285416,326687,-41271
2034-11,354905,23982,41857,10890,163720,215064,5699,25592,3710,2873,37.51,0,87.12,378887,462822,-83935
2034-12,473219,23511,31340,9078,165627,85049,15125,37638,4116,3165,107.4,1,83.69,496730,343857,152873
2035-01,275927,46757,27225,5565,156681,156088,20788,27948,975,774,267.96,0,81.04,322684,394295,-71611
2035-02,299418,22168,44790,9524,142555,114198,5817,23508,2726,1987,192.52,0,133.59,321586,340392,-18806
2035-03,205024,45522,44496,6608,179541,224605,11688,35020,1836,1643,32.23,1,142.18,250546,501958,-251412
2035-04,401670,11715,35741,14195,198913,133768,24188,22986,4735,3942,60.6,1,137.13,413385,429791,-16406
2035-05,159118,36063,24319,12344,137783,179834,6714,17036,4486,790,83.59,0,87.42,195181,378030,-182849
2035-06,333533,10192,29424,5110,162620,81848,19800,35993,3169,2033,131.96,0,128.35,343725,334795,8930
2035-07,462187,21700,37890,9111,111145,119169,15992,25016,769,3531,521.91,0,126.75,483887,318323,165564
2035-08,353124,48570,30092,9991,84835,67731,13792,21042,2527,3997,204.39,1,144.56,401694,227483,174211
2035-09,442551,46973,28336,6560,92371,132115,16640,28983,1791,1134,314.78,1,118.95,489524,305005,184519
2035-10,196719,39204,33539,13259,92998,205315,26575,27154,2130,3883,146.6,1,128.8,235923,398840,-162917
2035-11,206990,27914,44827,12109,181366,155874,14543,5204,1435,2867,57.6,0,84.67,234904,413923,-179019
2035-12,377055,40092,47413,9723,125791,95502,18248,6490,2735,3243,106.64,1,115.67,417147,303167,113980
2036-01,351580,20355,40782,12725,100601,165227,25296,32361,3284,3775,60.8,0,118.26,371935,376992,-5057
2036-02,123206,42616,41704,11747,188976,224658,17594,18867,1862,1759,68.43,0,145.97,165822,503546,-337724
2036-03,214706,36875,32813,10052,155328,200620,19739,27682,1678,777,168.35,1,145.03,251581,446234,-194653
2036-04,203512,31090,35667,7210,162115,197872,17845,12688,1739,583,183.29,1,108.89,234602,433397,-198795
2036-05,141977,40337,32987,9614,83068,241793,16871,22423,3399,2193,123.93,0,110.88,182314,406756,-224442
2036-06,226914,26641,47028,12126,114596,170128,13642,23170,2026,3924,137.75,0,128.6,253555,380690,-127135
2036-07,293439,20299,25695,8853,158328,106441,12184,10983,2255,3798,59.79,0,80.45,313738,322484,-8746
2036-08,114185,42110,45919,11494,187052,241756,25894,37378,4112,2025,-68.68,1,141.85,156295,549493,-393198
2036-09,341304,45827,37448,8769,179480,181150,19196,30628,3080,1075,172.42,1,92.75,387131,456671,-69540
2036-10,223334,26432,45507,13592,132626,144812,15500,13606,2510,3868,80.95,1,105.79,249766,365643,-115877
2036-11,431579,30656,30151,7854,93522,114062,15439,32950,3306,1364,24.81,0,80.69,462235,293978,168257
2036-12,231075,43210,48113,9787,80768,180630,26547,17851,1282,1121,187.96,1,111.06,274285,363696,-89411
2037-01,235742,21873,43852,14928,146626,144489,14301,23413,4854,3975,35.27,0,140.22,257615,387609,-129994
2037-02,246071,47387,24329,8219,113125,241424,22475,26945,4142,2345,15.7,0,97.32,293458,436517,-143059
2037-03,247653,30306,35781,5560,84102,58259,14917,27109,4093,1996,56.16,1,80.91,277959,225728,52231
2037-04,460896,21940,36612,8008,172800,236950,18611,12045,4504,2997,161.93,1,137.09,482836,485026,-2190
2037-05,382765,27685,49767,10781,183095,92592,5566,16536,1381,1911,337.54,0,105.18,410450,358337,52113
2037-06,492488,24410,47933,12089,158131,75670,27516,32279,2284,3480,276.32,0,102.41,516898,353618,163280
2037-07,338662,17898,40268,13033,175566,128923,15394,9101,755,2334,503.6,0,122.21,356560,382285,-25725
2037-08,344395,27908,30430,8691,173580,163656,18971,5310,766,667,397.34,1,129.66,372303,400638,-28335
2037-09,305579,35894,33760,13151,164127,167231,14984,21837,969,868,267.79,1,93.27,341473,415090,-73617
2037-10,490614,37155,30351,6437,176574,81683,8932,12465,1386,1779,349.18,1,110.87,527769,316442,211327
2037-11,263325,11522,28879,8012,176412,83429,14807,7113,2628,1713,59.39,0,132.23,274847,318652,-43805
2037-12,202950,17377,32993,9107,123927,88747,11182,39101,1359,1499,217.15,1,109.14,220327,305057,-84730
2038-01,268533,32425,31419,6854,93847,128123,25139,8371,1483,951,194.32,0,116.18,300958,293753,7205
2038-02,290651,21472,39648,14421,182710,76622,7646,25140,3557,1422,34.88,0,148.51,312123,346187,-34064
2038-03,365492,13283,26718,11267,185803,178845,5143,23477,2165,1899,165.02,1,120.87,378775,431253,-52478
2038-04,164980,47240,40746,13164,164566,231466,9554,23624,4723,2685,23.41,1,112.68,212220,483120,-270900
2038-05,173630,30221,22614,11400,161319,56798,19122,7667,4493,943,78.06,0,93.57,203851,278920,-75069
2038-06,275357,37608,27241,13365,137142,190367,7385,7773,686,1939,446.54,0,134.98,312965,383273,-70308
2038-07,234969,36647,48323,10915,194507,226296,8977,30691,2644,2129,13.89,0,91.95,271616,519709,-248093
2038-08,344953,40830,27775,13699,110782,137740,10182,7690,1667,2961,196.73,1,147.69,385783,307868,77915
2038-09,171554,35489,42601,9500,174869,56845,29166,27469,4177,2687,52.46,1,138.24,207043,340450,-133407
2038-10,230220,12438,25950,9266,195829,227206,5282,11208,3265,2761,85.09,1,133.09,242658,474741,-232083
2038-11,132672,21117,22837,14205,191632,65176,15530,29673,981,3350,116.64,0,136.62,153789,339053,-185264
2038-12,383691,19517,23813,6305,146813,61674,14190,16503,703,3872,453.47,1,105.47,403208,269298,133910
2039-01,375372,19299,45398,5059,140399,146929,23010,19056,2535,1023,132.13,0,115.47,394671,379851,14820
2039-02,258827,31226,35820,10084,133364,156513,16633,21945,4092,1785,191.76,0,109.06,290053,374359,-84306
2039-03,499164,26243,23434,14133,90514,62469,13880,15875,827,3984,659.97,1,116.68,525407,220305,305102
2039-04,235208,26140,48034,8099,125364,112101,13080,25886,3271,561,56.07,1,125.53,261348,332564,-71216
2039-05,372073,37741,48942,14037,90690,104522,25570,24707,3296,1591,194.13,0,93.45,409814,308468,101346
2039-06,262314,39895,37070,12460,133115,229639,16751,26436,3586,322,29.6,0,129.99,302209,455471,-153262
2039-07,261129,26357,45826,11738,151735,158247,10886,36425,3964,755,86.04,0,91.36,287486,414857,-127371
2039-08,225850,40707,37414,5520,96531,216090,27157,33026,1844,625,175.89,1,113.54,266557,415738,-149181
2039-09,301700,11248,40309,14587,134899,222073,24539,26809,2065,696,150.93,1,87.9,312948,463216,-150268
2039-10,294837,18294,43999,13622,169338,195581,9726,31712,4017,3102,77.6,1,92.68,313131,463978,-150847
2039-11,482604,45682,35780,6669,87281,59356,9493,33500,2048,1659,269.17,0,138.15,528286,232079,296207
2039-12,466600,45321,39601,9400,138603,190138,21647,11514,3850,626,105.65,1,112.93,511921,410903,101018
2040-01,149146,15548,36377,8597,188947,75498,22714,37722,3641,2739,52.31,0,132.27,164694,369855,-205161
2040-02,341350,42678,27739,7479,179918,71051,17903,16812,4854,1959,-2.74,0,124.6,384028,320902,63126
2040-03,442909,23144,28961,12054,126056,95839,18035,7527,3855,926,123.52,1,111.44,466053,288472,177581
2040-04,326774,17868,31031,12486,171743,207906,17409,5314,670,2129,576.54,1,147.96,344642,445889,-101247
2040-05,448758,45225,39711,14517,170160,134989,22555,30996,2422,3873,138.7,0,115.08,493983,412928,81055
2040-06,285391,36971,35956,14535,136848,177924,27549,35601,3146,1586,108.95,0,99.25,322362,428413,-106051
2040-07,341553,22070,36464,5540,129004,145964,13507,15257,1345,2343,286.4,0,101.32,363623,345736,17887
2040-08,183348,21630,24950,13964,131779,184941,11778,27552,2919,928,105.03,1,110.09,204978,394964,-189986
2040-09,405891,39615,25753,5818,185611,161003,9814,22823,2367,1694,168.59,1,145.09,445506,410822,34684
2040-10,374339,16574,47859,5503,126550,56576,26437,31971,654,1288,569.73,1,139.96,390913,294896,96017
2040-11,469391,36127,34777,14532,151651,116980,22811,22932,850,2619,586.01,0,137.99,505518,363683,141835
2040-12,400129,26121,27294,9185,195547,131996,16541,30441,3046,532,116.23,1,108.94,426250,411004,15246
2041-01,142027,48983,29913,9847,156191,67870,8317,17903,2283,2601,119.52,0,91.2,191010,290041,-99031
2041-02,364647,41220,41946,5182,97775,195725,24482,25097,1460,3822,300.85,0,136.11,405867,390207,15660
2041-03,446029,14102,38928,5727,150987,111001,19314,12778,1487,3287,326.99,1,85.53,460131,338735,121396
2041-04,168950,36519,49093,9899,126634,220000,9606,33744,3984,1019,-75.7,1,115.71,205469,448976,-243507
2041-05,156832,48601,48033,6425,156102,64121,16071,18768,2465,2485,27.15,0,90.72,205433,309520,-104087
2041-06,197436,17681,41677,7429,165585,128306,29780,35140,4400,2088,4.51,0,117.02,215117,407917,-192800
2041-07,146257,21745,48776,14444,81411,159081,24952,27968,1542,1505,55.29,0,95.39,168002,356632,-188630
2041-08,124892,26109,31238,14108,132064,192091,24779,18058,1374,1967,97.23,1,94.91,151001,412338,-261337
2041-09,205543,39151,38442,5736,162640,70437,21195,35331,4068,2552,1.68,1,110.09,244694,333781,-89087
2041-10,328901,35988,23516,8723,180259,110195,17596,34943,4493,3838,3.71,1,131.53,364889,375232,-10343
2041-11,239348,17998,29768,7789,145828,161992,24998,16629,1746,555,113.08,0,118.15,257346,387004,-129658
2041-12,210689,48807,29524,10671,81457,112961,11075,27413,2715,1946,90.16,1,118.13,259496,273101,-13605
2042-01,474315,36415,28807,8520,134306,81883,18236,17618,1030,2856,458.6,0,101.98,510730,289370,221360
2042-02,422158,34174,49896,5846,185636,199669,23501,35335,2560,2998,170.05,0,112.2,456332,499883,-43551
2042-03,177404,33354,22167,11595,98615,204268,11826,35863,4680,2792,68.0,1,104.15,210758,384334,-173576
2042-04,483499,38201,28018,8850,189152,126079,27648,6775,3265,540,257.45,1,119.18,521700,386522,135178
2042-05,407439,28596,46611,13505,130845,142774,21815,28357,4531,2529,54.86,0,92.8,436035,383907,52128
2042-06,356897,32056,35530,9933,114002,144062,7336,27045,1650,2570,127.44,0,93.97,388953,337908,51045
2042-07,194433,12980,31465,7888,140689,105686,27402,5533,1192,2697,164.88,0,141.77,207413,318663,-111250
2042-08,191613,28578,35273,11482,157772,65815,8877,32716,2490,3615,108.78,1,121.88,220191,311935,-91744
2042-09,254601,16360,40900,11607,83366,87278,20779,27711,2778,1798,124.71,1,133.99,270961,271641,-680
2042-10,427357,40501,32947,12672,106448,198478,22826,12459,3790,2737,144.1,1,144.74,467858,385830,82028
2042-11,394597,33263,27563,7835,172420,64978,22288,8535,3417,966,131.5,0,96.56,427860,303619,124241
2042-12,150084,27838,40929,14070,180980,161614,16601,32497,800,498,163.23,1,115.24,177922,446691,-268769
2043-01,414219,27313,35640,5210,82020,74340,20209,21804,3858,3777,81.09,0,133.04,441532,239223,202309
2043-02,354461,49922,23167,13378,188360,246026,24851,31467,3391,3419,196.68,0,84.72,404383,527249,-122866
2043-03,167987,29130,45194,13468,177972,172554,17630,38330,4108,3406,-26.96,1,147.84,197117,465148,-268031
2043-04,365005,46826,42544,7829,199589,197037,8270,18456,2725,1289,120.21,1,139.51,411831,473725,-61894
2043-05,404983,41196,31470,12601,124251,72644,20392,31386,3256,2168,132.98,0,135.72,446179,292744,153435
2043-06,192308,28296,31410,10808,102233,200606,7990,19963,1924,1646,97.85,0,114.93,220604,373010,-152406
2043-07,326019,45638,27295,6355,88333,163458,18851,13052,4919,1702,192.07,0,139.2,371657,317344,54313
2043-08,454073,41072,42941,8720,162609,183043,25867,17657,2375,1248,230.51,1,110.04,495145,440837,54308
2043-09,359583,18970,20719,5518,188632,168155,9791,26772,2104,1595,54.43,1,93.87,378553,419587,-41034
2043-10,107978,41509,39764,14928,164716,140851,19965,12585,4263,1388,37.59,1,128.34,149487,392809,-243322
2043-11,139343,31830,34468,6259,152907,237875,14159,31698,1730,2882,70.11,0,134.63,171173,477366,-306193
2043-12,245350,35775,30180,11388,109457,120758,22740,37077,3966,3281,74.53,1,113.31,281125,331600,-50475
2044-01,318793,21828,32902,5508,122668,242210,25838,8574,1500,3394,276.92,0,95.6,340621,437700,-97079
2044-02,226736,14308,26504,13047,102873,196100,5254,6754,3723,3589,41.96,0,124.79,241044,350532,-109488
2044-03,384037,38009,28068,7534,162946,186601,7414,32090,3118,516,23.24,1,91.17,422046,424653,-2607
2044-04,356515,18336,33912,7609,168364,147166,17438,30816,4202,3761,103.03,1,85.38,374851,405305,-30454
2044-05,193857,31397,48221,13279,104440,210234,9841,35744,4110,448,39.98,0,135.21,225254,421759,-196505
2044-06,325082,38086,29751,10254,106267,210841,18219,18109,3933,686,88.82,0,118.99,363168,393441,-30273
2044-07,405139,17858,26061,5834,107197,191474,16445,21280,1930,1948,195.58,0,82.74,422997,368291,54706
2044-08,343295,41279,30964,14855,110121,165008,29423,32225,4490,2721,132.36,1,121.61,384574,382596,1978
2044-09,227972,37650,29329,7218,119462,66889,13013,30393,1648,3012,208.95,1,128.87,265622,266304,-682
2044-10,136376,40943,24526,11586,131393,110775,5491,33531,3426,1267,-28.11,1,131.96,177319,317302,-139983
2044-11,477200,40975,29779,8975,127473,205997,13913,36894,1425,1910,423.01,0,132.95,518175,423031,95144
2044-12,403319,36744,43820,8333,194162,233388,25184,12472,2316,2978,228.67,1,130.35,440063,517359,-77296
2045-01,251616,43156,31929,12941,101395,194401,16458,8649,1465,465,111.34,0,131.93,294772,365773,-71001
2045-02,303290,48326,34831,6489,193210,119199,20646,14891,577,587,479.35,0,135.01,351616,389266,-37650
2045-03,187959,34387,43933,7253,104908,66340,29754,14651,3589,1332,100.2,1,87.52,222346,266839,-44493
2045-04,181072,36834,41497,13061,116113,115312,22244,6507,926,2366,166.8,1,101.92,217906,314734,-96828
2045-05,487241,38546,31771,9184,109272,167945,23705,35657,1966,3984,209.11,0,133.18,525787,377534,148253
2045-06,103040,26018,43345,14200,155120,56041,27458,17356,1715,1686,134.33,0,118.11,129058,313520,-184462
2045-07,335085,24630,49177,14920,186091,199319,18825,31524,4776,3616,3.63,0,93.72,359715,499856,-140141
2045-08,180322,44636,35695,5073,198332,132628,16375,30802,1387,409,172.96,1,119.57,224958,418905,-193947
2045-09,114512,34724,25469,11783,136735,172676,12758,17103,1259,2664,108.22,1,141.14,149236,376524,-227288
2045-10,211311,41903,21898,5601,157457,102804,28179,35253,1889,2221,157.3,1,149.56,253214,351192,-97978
2045-11,465902,49637,22680,10959,157859,55825,21939,37191,598,3969,821.4,0,113.78,515539,306453,209086
2045-12,243632,38873,46456,14671,194726,106474,6252,34699,1808,3951,152.39,1,88.61,282505,403278,-120773
2046-01,269403,46554,41094,6066,96506,60619,27889,6938,4201,444,61.82,0,140.45,315957,239112,76845
2046-02,132949,21737,20274,7095,142592,220326,22851,32980,666,2909,154.66,0,125.26,154686,446118,-291432
2046-03,443256,16367,20153,9263,85598,124624,19472,19872,3979,3648,168.15,1,114.59,459623,278982,180641
2046-04,479575,22056,21705,8707,155694,211651,6064,27086,2484,2517,234.37,1,100.58,501631,430907,70724
2046-05,473242,28524,43073,9667,132255,156708,17398,12170,1605,1706,281.19,0,123.58,501766,371271,130495
2046-06,354976,34092,48061,13077,133742,120852,28042,17082,683,2511,487.72,0,90.53,389068,360856,28212
2046-07,296203,29198,43270,6265,171340,143987,5671,24955,2369,545,33.03,0,100.25,325401,395488,-70087
2046-08,188875,37507,41018,5337,142202,174731,21153,29441,1342,1626,157.62,1,142.33,226382,413882,-187500
2046-09,185079,31916,22691,11991,110134,195824,25486,14241,4623,823,-5.6,1,116.43,216995,380367,-163372
2046-10,206173,41493,20245,12796,193055,76320,18261,36106,2672,3811,79.33,1,140.79,247666,356783,-109117
2046-11,335061,10527,34115,11663,114726,186126,26696,26588,3793,3188,98.74,0,110.72,345588,399914,-54326
2046-12,101938,36502,25542,14405,99745,134948,26422,15630,4960,1938,71.11,1,98.69,138440,316692,-178252
2047-01,311012,24101,24512,8104,87474,200952,10583,33413,4246,3152,15.19,0,137.95,335113,365038,-29925
2047-02,324990,20910,20345,5582,179993,57951,9742,17424,1485,2362,255.37,0,82.13,345900,291037,54863
2047-03,165417,25034,47166,6387,148969,137772,27702,35786,3326,1571,56.2,1,117.74,190451,403782,-213331
2047-04,145021,46133,26658,7030,88392,109513,14882,31927,650,3590,208.76,1,90.0,191154,278402,-87248
2047-05,297972,48126,22061,12646,170968,108483,7446,12231,1892,835,121.17,0,139.19,346098,333835,12263
2047-06,191512,22270,44475,13225,197399,193271,5421,38464,1574,2767,149.05,0,128.59,213782,492255,-278473
2047-07,287353,36249,39127,10589,130830,129153,13426,25357,858,2223,344.06,0,137.74,323602,348482,-24880
2047-08,231076,23211,44012,10857,80756,107404,16374,26383,1302,697,135.83,1,96.59,254287,285786,-31499
2047-09,378777,12684,26131,5633,172143,186791,13961,7311,1947,1964,126.77,1,142.02,391461,411970,-20509
2047-10,117467,24896,48098,5853,106503,163250,25890,37101,2746,3892,51.36,1,149.97,142363,386695,-244332
2047-11,428032,31923,30845,10432,159296,182013,28688,23152,3265,3706,71.1,0,122.97,459955,434426,25529
2047-12,256941,19679,32257,10082,162517,248507,23569,32560,2929,2067,112.21,1,133.56,276620,509492,-232872
2048-01,366901,19835,39827,5685,101219,122785,18376,39457,2457,1296,134.68,0,137.57,386736,327349,59387
2048-02,262255,29158,33990,12380,131328,215920,20757,17287,2196,3253,27.08,0,143.37,291413,431662,-140249
2048-03,414266,19840,44404,6234,102693,130012,17791,30404,4988,2319,166.25,1,149.61,434106,331538,102568
2048-04,154902,36769,30921,11449,98983,81865,18818,10156,2423,2693,94.51,1,118.61,191671,252192,-60521
2048-05,464293,44901,23797,9091,157282,170426,8113,38730,1310,2493,315.11,0,122.55,509194,407439,101755
2048-06,171827,37393,37631,8841,152475,199748,16372,9592,1697,3247,97.32,0,127.61,209220,424659,-215439
2048-07,270632,16976,28928,7442,83710,109549,20638,28723,3823,3414,125.58,0,104.21,287608,278990,8618
2048-08,493141,28324,21632,11320,164065,203022,14247,33772,1351,2924,284.63,1,102.62,521465,448058,73407
2048-09,385475,27143,30079,11625,117271,108744,13153,20262,3284,664,159.26,1,145.78,412618,301134,111484
2048-10,266066,16206,28155,12787,170776,86235,29093,37982,1942,3029,132.82,1,127.66,282272,365028,-82756
2048-11,211756,48083,42667,5761,171866,124559,14902,14445,4222,1539,37.83,0,132.74,259839,374200,-114361
2048-12,352470,19562,21434,6743,92077,124530,18429,6106,3616,2114,95.66,1,84.34,372032,269319,102713
2049-01,145432,32407,22120,12597,148096,160677,10160,5595,4340,3060,-39.27,0,143.15,177839,359245,-181406
2049-02,289017,18541,34892,8064,97062,94946,6363,18853,2199,331,194.71,0,147.32,307558,260180,47378
2049-03,192947,30128,29820,9526,86111,165667,7143,30887,3711,3197,26.53,1,104.08,223075,329154,-106079
2049-04,298958,25688,26706,9942,152953,236272,23194,31117,3018,2896,62.68,1,115.21,324646,480184,-155538
2049-05,248752,40718,39237,8614,172924,178575,11247,23764,834,3126,246.19,0,91.74,289470,434361,-144891
2049-06,204153,11617,30237,9769,113741,110664,28528,9508,4112,715,70.44,0,134.06,215770,302447,-86677
2049-07,488934,46491,24208,14272,132420,246510,15020,33475,2005,2150,249.19,0,143.85,535425,465905,69520
2049-08,358379,47634,37293,7108,105556,100140,28215,31580,2336,1492,265.0,1,108.77,406013,309892,96121
2049-09,392775,16987,22316,14686,85022,237760,26093,19471,910,2938,388.89,1,149.47,409762,405348,4414
2049-10,452482,47699,37185,14665,179804,122116,26790,11886,1399,1779,394.6,1,107.37,500181,392446,107735
2049-11,415453,38565,24781,10391,124111,105398,10399,13125,3985,3056,167.86,0,126.56,454018,288205,165813
2049-12,262480,41991,46976,13408,170124,162182,13012,35810,984,911,279.35,1,131.68,304471,441512,-137041
2050-01,250451,46550,20435,8617,97058,111332,22495,39449,1909,2487,167.47,0,107.21,297001,299386,-2385
2050-02,455434,21851,33453,11915,80619,201800,19700,17992,1677,3644,317.96,0,118.06,477285,365479,111806
2050-03,308004,17720,21507,6901,96185,140976,29251,15825,2702,1161,171.95,1,83.89,325724,310645,15079
2050-04,394897,40860,49880,7569,117907,103210,8325,19523,4375,862,49.91,1,149.23,435757,306414,129343
2050-05,174023,29861,26580,8147,124984,151529,15404,6255,4132,1411,55.53,0,128.19,203884,332899,-129015
2050-06,122867,28202,28730,11826,133806,203822,24813,14060,1578,1890,93.91,0,126.03,151069,417057,-265988
2050-07,305702,21653,20269,7365,115550,134251,15511,5752,573,3550,514.22,0,111.25,327355,298698,28657
2050-08,136240,39118,20691,10286,187870,153064,15468,25032,4993,3409,23.81,1,115.98,175358,412411,-237053
2050-09,292218,48096,46579,13575,89523,215546,7569,7296,1357,361,176.3,1,140.44,340314,380088,-39774
2050-10,464056,47720,31475,6355,172735,181955,5927,31515,835,1288,556.5,1,97.19,511776,429962,81814
2050-11,375829,34646,31461,14203,165036,100127,8386,14912,2943,601,155.01,0,88.92,410475,334125,76350
2050-12,222743,36747,47489,7255,179930,102773,24081,27623,4942,1876,69.24,1,113.05,259490,389151,-129661
2051-01,475112,32506,26246,14019,160483,143788,27749,7003,573,1989,845.81,0,131.72,507618,379288,128330
2051-02,381916,46511,47073,14233,91728,146836,12730,30846,2600,671,189.83,0,133.97,428427,343446,84981
2051-03,445970,38760,26391,13153,199202,217166,14877,14071,806,1097,607.62,1,121.57,484730,484860,-130
2051-04,320958,46776,21309,14054,103545,216435,8444,38610,4428,2528,120.48,1,108.94,367734,402397,-34663
2051-05,299656,27391,36501,13137,199115,217266,21022,28415,667,1665,450.33,0,91.05,327047,515456,-188409
2051-06,267770,31946,47913,6392,165794,113827,18272,16447,1665,865,153.9,0,80.13,299716,368645,-68929
2051-07,122327,42591,30777,6324,151922,75294,12019,15753,4733,2454,-67.75,0,111.59,164918,292089,-127171
2051-08,138711,32136,49912,6558,189806,140989,20187,8372,921,659,152.55,1,110.42,170847,415824,-244977
2051-09,216223,27596,34684,13801,155325,140827,14496,21490,3871,1367,100.23,1,124.95,243819,380623,-136804
2051-10,449545,40435,27018,12970,199179,81543,7019,19179,4967,3546,82.06,1,104.7,489980,346908,143072
2051-11,385760,48977,38458,9439,96087,134679,15921,34280,663,3964,605.5,0,95.28,434737,328864,105873
2051-12,186889,38697,34981,14938,120152,134442,9796,29480,2496,1415,151.24,1,140.08,225586,343789,-118203
2052-01,342916,37720,25759,12654,161516,130138,20088,15886,4880,1879,123.42,0,82.26,380636,366041,14595
2052-02,109552,25845,20534,6749,143338,210927,24561,5271,2982,3896,36.67,0,97.59,135397,411380,-275983
2052-03,100975,15577,20854,14080,127090,130191,25457,32785,3005,2584,93.33,1,126.5,116552,350457,-233905
2052-04,336935,25557,31890,8437,97302,147079,25493,19856,4380,1275,153.72,1,114.09,362492,330057,32435
2052-05,284710,29947,24778,7052,86903,138434,7087,18005,526,1104,616.9,0,101.46,314657,282259,32398
2052-06,104743,33342,33078,10642,196086,155104,17932,7955,2583,3820,98.95,0,117.97,138085,420797,-282712
2052-07,111085,46505,22368,6215,84462,207903,8321,23670,902,637,161.94,0,105.03,157590,352939,-195349
2052-08,422894,16591,36202,10483,118927,175540,23978,28671,3975,1274,109.41,1,83.71,439485,393801,45684
2052-09,359314,39247,47534,14594,126727,106406,26106,19699,1743,701,175.56,1,83.5,398561,341066,57495
2052-10,161883,35856,23155,5403,123458,203775,21156,38182,3480,1024,-17.68,1,96.38,197739,415129,-217390
2052-11,137842,22727,40419,7419,128275,162162,14122,19052,4505,2745,108.86,0,144.21,160569,371449,-210880
2052-12,312115,44472,36351,14580,101335,182318,28392,8671,2942,772,184.49,1,93.9,356587,371647,-15060
2053-01,288312,15017,38610,6110,159721,87612,29721,22149,3749,3860,38.98,0,126.45,303329,343923,-40594
2053-02,370175,37457,47841,12551,97894,118129,24191,34983,1042,2298,365.87,0,119.24,407632,335589,72043
2053-03,370556,40609,39492,12218,125032,71693,18450,19079,2937,1619,128.58,1,145.9,411165,285964,125201
2053-04,435900,11123,45670,8612,138868,76843,12947,13976,2429,363,221.06,1,139.15,447023,296916,150107
2053-05,224665,26961,26214,14639,127607,139591,12441,9412,1131,3626,198.86,0,123.46,251626,329904,-78278
2053-06,201280,32094,31687,7584,118396,153888,21302,14105,1175,2607,103.79,0,91.76,233374,346962,-113588
2053-07,262337,27263,36703,7695,159130,147657,29172,10079,3775,1345,139.73,0,81.16,289600,390436,-100836
2053-08,211385,18906,20173,6731,180089,151014,15044,34808,2267,3288,198.23,1,88.17,230291,407859,-177568
2053-09,238047,44254,26613,9817,143364,104775,27274,10482,1554,1359,140.07,1,106.81,282301,322325,-40024
2053-10,200426,39171,32664,6871,97081,210774,12877,29922,3600,3093,74.78,1,82.96,239597,390189,-150592
2053-11,331946,40906,39175,14110,181315,140599,17614,8711,3887,1541,-22.21,0,87.29,372852,401524,-28672
2053-12,380447,35564,28738,10190,187142,109242,18986,20240,2687,706,115.32,1,112.3,416011,374538,41473
2054-01,483726,20821,43752,5549,90304,173408,24566,29351,3633,3255,132.14,0,81.05,504547,366930,137617
2054-02,323903,42577,44375,11797,139320,235257,15310,18065,2086,3749,126.78,0,104.26,366480,464124,-97644
2054-03,155447,29254,23758,6834,96729,181050,24047,14938,2377,765,62.84,1,80.33,184701,347356,-162655
2054-04,137814,23721,22295,14408,97465,181061,19308,15515,4096,576,3.18,1,125.07,161535,350052,-188517
2054-05,411556,27864,44685,6143,91554,106099,19291,10427,3405,1208,74.78,0,109.78,439420,278199,161221
2054-06,426757,25147,48603,7072,149924,162970,7200,23066,541,1547,802.43,0,118.49,451904,398835,53069
2054-07,214975,43643,27820,7402,101060,98276,20372,34426,4516,3240,26.04,0,119.99,258618,289356,-30738
2054-08,211173,21260,33617,12577,82756,141062,28429,19703,4034,3156,76.82,1,91.3,232433,318144,-85711
2054-09,232464,40017,25320,5803,182221,150823,16742,11454,3449,2379,46.94,1,140.8,272481,392363,-119882
2054-10,443803,32026,44217,10900,143583,90835,16461,12342,4017,318,195.06,1,119.37,475829,318338,157491
2054-11,435224,40629,24753,10882,126063,138679,23897,18449,665,1975,631.49,0,83.51,475853,342723,133130
2054-12,443636,30231,47006,13642,91688,142864,26196,5992,2817,1840,215.31,1,112.1,473867,327388,146479
2055-01,438562,25074,23657,9202,147472,131743,16885,28324,876,3875,505.91,0,142.34,463636,357283,106353
2055-02,218753,43886,37988,5958,171780,95813,25890,26038,3848,2842,54.59,0,90.33,262639,363467,-100828
2055-03,347845,48962,31108,8652,122009,85778,12954,30024,4765,3969,81.35,1,101.32,396807,290525,106282
2055-04,304031,35133,43497,7035,113673,243608,17884,28312,1395,3350,242.49,1,104.02,339164,454009,-114845
2055-05,221458,39703,35196,6372,157371,81821,7945,18520,4733,468,32.08,0,144.52,261161,307225,-46064
2055-06,166350,27976,32609,10364,113613,89548,7685,29131,4858,3975,9.49,0,98.64,194326,282950,-88624
2055-07,338088,45592,21417,6579,181920,107028,22488,15680,634,989,448.82,0,118.2,383680,355112,28568
2055-08,160211,44487,42131,7415,121315,116649,19122,32925,4093,2072,77.8,1,92.61,204698,339557,-134859
2055-09,440399,28376,25843,14146,191790,185462,22119,28888,3353,3565,87.14,1,81.33,468775,468248,527
2055-10,417836,19172,31233,13712,111502,209349,25784,6465,2026,478,175.51,1,98.06,437008,398045,38963
2055-11,439485,49000,26013,11511,123195,233845,20459,19486,3105,1663,146.41,0,108.44,488485,434509,53976
2055-12,212581,12573,46947,8728,87023,157619,17489,18014,4638,1271,89.55,1,87.54,225154,335820,-110666
2056-01,268375,12750,49071,9762,128108,97292,10241,27377,3460,1727,16.76,0,137.3,281125,321851,-40726
2056-02,262319,40473,24655,9066,104252,69924,21812,12363,2230,3557,141.94,0,131.02,302792,242072,60720
2056-03,467548,17420,22569,9139,81819,122577,18049,11987,2515,2152,229.83,1,142.33,484968,266140,218828
2056-04,314029,44704,35862,6102,138899,93713,24790,31435,3730,2253,95.01,1,146.73,358733,330801,27932
2056-05,459177,37425,38307,13225,90797,249388,18664,9034,2021,779,139.49,0,97.59,496602,419415,77187
2056-06,413191,47231,38198,5562,176951,62075,24670,36628,2541,2900,156.31,0,96.63,460422,344084,116338
2056-07,144719,32951,33177,14098,194088,221147,26741,8746,3403,3255,45.5,0,101.89,177670,497997,-320327
2056-08,479690,11795,25259,7734,174914,163344,22010,38670,3533,2249,163.93,1,120.64,491485,431931,59554
2056-09,436361,24154,36532,13519,126129,67431,12611,18686,3247,2021,147.74,1,100.48,460515,274908,185607
2056-10,397822,18818,21327,8730,179584,198607,7809,29680,1807,3077,223.52,1,86.84,416640,445737,-29097
2056-11,439809,21678,49744,12994,198483,139944,15241,34776,1103,638,374.72,0,125.25,461487,451182,10305
2056-12,371811,28767,30484,6000,99502,228487,17768,12515,3592,2839,140.08,1,135.71,400578,394756,5822
2057-01,169961,13503,21854,10973,172163,188704,19306,8544,4557,494,70.36,0,98.53,183464,421544,-238080
2057-02,157562,33493,20633,5867,134113,142690,25850,17415,1835,2604,152.53,0,103.03,191055,346568,-155513
2057-03,455499,48153,43594,5513,145265,58858,15289,33464,2706,1606,199.0,1,91.49,503652,301983,201669
2057-04,413537,49147,43781,10641,145894,66690,29982,24741,2784,335,141.48,1,110.79,462684,321729,140955
2057-05,346837,48818,47259,13080,123312,106999,13854,29815,4985,2031,81.55,0,102.39,395655,334319,61336
2057-06,265947,12847,38896,6941,94710,197842,10900,17191,3443,2701,146.23,0,133.91,278794,366480,-87686
2057-07,286014,43306,32240,13310,111081,58126,8433,33796,4980,3177,39.02,0,139.04,329320,256986,72334
2057-08,246885,29364,27652,5120,113941,141572,5198,29340,2624,1790,114.46,1,146.58,276249,322823,-46574
2057-09,154218,44739,27568,10592,120577,110211,19241,28714,2815,1323,38.69,1,146.02,198957,316903,-117946
2057-10,389384,44847,26426,8837,159417,87113,27200,5256,2258,2359,176.11,1,94.33,434231,314249,119982
2057-11,121703,23965,34759,11618,149196,181097,8965,7690,4409,3302,-83.22,0,84.98,145668,393325,-247657
2057-12,442859,39274,45780,8189,146551,174115,28213,29635,4531,3319,100.18,1,103.37,482133,432483,49650
2058-01,493053,43807,33537,11999,171988,237558,25494,34372,795,1335,720.73,0,111.0,536860,514948,21912
2058-02,429861,23629,20283,14326,103504,184698,11242,7317,3375,3928,154.99,0,120.65,453490,341370,112120
2058-03,279038,25524,38199,8448,99458,61268,18812,8867,903,3817,383.5,1,108.93,304562,235052,69510
2058-04,293414,13792,28897,7550,157048,126610,29972,11910,1316,1922,251.26,1,86.97,307206,361987,-54781
2058-05,467530,38875,27328,14889,139222,79295,20314,8656,3938,3194,93.93,0,88.88,506405,289704,216701
2058-06,472966,41384,35424,11098,161522,137776,11833,33879,3365,479,152.27,0,94.87,514350,391532,122818
2058-07,417160,13668,38184,8168,181077,85080,25748,29124,2170,757,252.89,0,148.94,430828,367381,63447
2058-08,404701,27067,41733,8700,117089,104568,10849,25933,4418,2598,92.12,1,81.79,431768,308872,122896
2058-09,433769,32524,41114,8209,82062,228606,7938,15117,4686,493,108.74,1,125.8,466293,383046,83247
2058-10,121303,23499,35506,13127,142686,208021,15300,17442,2570,1333,66.84,1,107.33,144802,432082,-287280
2058-11,231598,11463,49508,10963,126040,187319,14641,23788,1791,3466,239.59,0,137.72,243061,412259,-169198
2058-12,340609,11416,43266,9083,81863,194482,8042,36812,1601,1898,178.29,1,126.24,352025,373548,-21523
2059-01,308375,40553,20259,5004,90175,242944,7945,6471,1596,3744,179.64,0,137.56,348928,372798,-23870
2059-02,144050,27502,41301,13373,199021,247992,20221,22266,4012,1351,-25.16,0,98.11,171552,544174,-372622
2059-03,477148,21538,42172,12293,88009,121177,5840,7417,4020,2011,105.66,1,125.11,498686,276908,221778
2059-04,494222,16952,20007,7610,148998,102333,13704,33708,4934,1436,41.12,1,115.19,511174,326360,184814
2059-05,161471,19324,26992,9185,132266,64351,19403,11059,1344,487,156.84,0,145.35,180795,263256,-82461
2059-06,134873,47455,36391,14940,187913,214163,12659,13303,560,2361,206.77,0,144.13,182328,479369,-297041
2059-07,103578,27872,38405,6235,86311,197736,24566,9998,1740,2392,93.13,0,123.14,131450,363251,-231801
2059-08,239416,30793,46759,5695,88714,69525,10838,26486,2851,1577,56.14,1,89.04,270209,248017,22192
2059-09,194477,12096,41560,5941,107270,91552,9252,12233,2437,3148,84.45,1,119.56,206573,267808,-61235
2059-10,304252,17670,33233,11752,183661,227467,29953,22463,1380,2847,144.79,1,88.16,321922,508529,-186607
2059-11,199629,49353,36702,5187,196004,135635,9811,16988,4382,3253,43.65,0,81.35,248982,400327,-151345
2059-12,427588,45803,47875,9431,171037,219149,23929,6205,2052,3627,116.21,1,91.14,473391,477626,-4235
2060-01,264097,46828,24101,13621,96963,189443,25668,27689,1403,487,178.66,0,144.27,310925,377485,-66560
2060-02,161515,21722,48511,11049,96055,210923,24773,28138,4768,1005,-46.58,0,122.1,183237,419449,-236212
2060-03,484285,19916,34641,14425,106718,86843,23406,39031,3867,1172,60.89,1,108.12,504201,305064,199137
2060-04,221691,24797,21661,11438,150143,75526,18703,22758,4997,1147,-21.89,1,129.99,246488,300229,-53741
2060-05,144811,44594,32120,9988,152778,126278,10179,39668,4280,3374,85.3,0,124.41,189405,371011,-181606
2060-06,497522,40070,27166,12858,148711,181508,7057,25241,4240,1220,124.52,0,94.45,537592,402541,135051
2060-07,400507,41456,20400,8758,177749,79103,17123,34455,2191,803,91.57,0,89.62,441963,337588,104375
2060-08,262488,12878,22027,14505,197031,212658,20927,18695,3568,3570,61.92,1,100.92,275366,485843,-210477
2060-09,343592,47095,31601,5871,142039,91173,24603,16900,1308,350,305.44,1,108.79,390687,312187,78500
2060-10,394422,47117,37533,13229,152312,76015,22419,13886,3013,3725,131.29,1,98.23,441539,315394,126145
2060-11,331012,15005,24859,7116,135748,176844,20880,28013,4321,2434,53.81,0,104.24,346017,393460,-47443
2060-12,490326,25227,25099,11349,94051,61968,5566,24180,3077,1670,131.8,1,141.99,515553,222213,293340
2061-01,295281,16556,45238,13217,158532,91464,29681,14662,3279,497,84.78,0,115.09,311837,352794,-40957
2061-02,161202,35802,35622,10541,93087,198572,23797,13658,1348,1895,109.81,0,138.53,197004,375277,-178273
2061-03,411598,11962,27287,10731,174930,152446,15324,36461,2598,2918,147.11,1,130.74,423560,417179,6381
2061-04,230902,21028,45954,11673,134957,224012,22222,8443,3569,2782,110.0,1,112.86,251930,447261,-195331
2061-05,462054,32311,39697,11675,128005,178618,8109,16011,3581,618,117.11,0,104.93,494365,382115,112250
2061-06,110587,15336,29801,12583,98488,187471,5190,5749,4334,1427,101.46,0,85.08,125923,339282,-213359
2061-07,431081,17386,41260,14037,164652,238268,9190,16409,1281,2669,377.93,0,135.17,448467,483816,-35349
2061-08,279707,20576,28933,9108,88775,230433,11070,20526,2592,3112,70.09,1,125.62,300283,388845,-88562
2061-09,225791,24952,43698,6411,130412,81746,12540,15174,4974,2937,95.47,1,106.49,250743,289981,-39238
2061-10,377498,44454,42061,5233,156379,124425,6931,16545,1456,3376,239.77,1,116.11,421952,351574,70378
2061-11,222713,21375,37015,7206,181811,229757,20741,34903,1762,1068,82.1,0,123.77,244088,511433,-267345
2061-12,180449,40063,29846,11113,103234,173997,27182,36830,4703,458,51.28,1,102.96,220512,382202,-161690
2062-01,353018,40096,34719,13433,175585,84488,7941,20029,1898,2898,159.22,0,107.79,393114,336195,56919
2062-02,180168,36733,46516,11061,90912,133037,20626,13291,2002,2953,55.85,0,132.66,216901,315443,-98542
2062-03,318926,15659,41221,12817,176580,226954,11328,37479,4554,2872,79.7,1,109.0,334585,506379,-171794
2062-04,434876,13644,43690,9120,167334,231975,17415,8619,878,487,447.36,1,116.08,448520,478153,-29633
2062-05,166899,35348,47023,13796,151115,205181,29749,9160,1156,3559,129.07,0,149.37,202247,456024,-253777
2062-06,321508,47208,21340,10700,176882,68427,25158,37819,4817,2975,-91.09,0,112.64,368716,340326,28390
2062-07,373094,39386,40752,11485,91604,144659,10832,20128,4641,3153,67.33,0,129.99,412480,319460,93020
2062-08,302403,42484,27664,13652,162564,203115,9386,38645,1086,1231,318.2,1,145.59,344887,455026,-110139
2062-09,236436,26938,48980,6771,133557,219935,15608,20377,2308,366,17.9,1,93.12,263374,445228,-181854
2062-10,250363,39802,44495,12481,156744,115115,27454,15712,2580,443,131.56,1,90.75,290165,372001,-81836
2062-11,211584,44576,33688,14890,94391,206585,17108,10964,751,2014,267.97,0,134.12,256160,377626,-121466
2062-12,453816,14592,49860,9370,94510,193506,21427,7951,3843,2598,153.73,1,114.74,468408,376624,91784
2063-01,482891,15825,20389,5814,156012,54228,17640,9249,3107,3850,194.77,0,141.69,498716,263332,235384
2063-02,353842,49026,27522,13111,135153,52496,12537,35511,4984,3218,-1.62,0,142.48,402868,276330,126538
2063-03,184230,49449,27960,6347,142813,229571,13025,33410,4720,2761,-16.25,1,104.62,233679,453126,-219447
2063-04,403351,25984,22896,7836,191544,53373,16826,17148,4084,3305,138.94,1,87.24,429335,309623,119712
2063-05,205285,10145,25583,9984,127539,75634,10614,24374,2224,524,50.38,0,134.52,215430,273728,-58298
2063-06,379285,18686,27556,13669,99289,53922,11029,39959,2819,2316,93.59,0,112.99,397971,245424,152547
2063-07,399985,37619,44144,10172,130522,90488,6307,16492,3390,1499,99.39,0,118.44,437604,298125,139479
2063-08,209706,29138,25376,10769,115534,204641,8416,20846,3993,1722,8.2,1,82.26,238844,385582,-146738
2063-09,306747,17610,42469,5351,121399,60381,18544,21086,1114,3446,224.77,1,118.43,324357,269230,55127
2063-10,210375,16873,47082,9623,105119,217473,18247,34482,4743,1900,75.61,1,104.13,227248,432026,-204778
2063-11,282405,22649,27320,11860,165581,126060,29966,9122,4660,3833,60.29,0,120.05,305054,369909,-64855
2063-12,199559,10909,37343,12660,199756,153238,23339,39743,1541,1160,138.07,1,119.64,210468,466079,-255611
2064-01,289083,24255,20082,9064,128761,227271,22098,34345,2743,3731,84.19,0,90.19,313338,441621,-128283
2064-02,179338,30628,25255,13164,119590,209834,21535,29933,4938,367,79.16,0,145.85,209966,419311,-209345
2064-03,210562,35383,32790,7832,170351,185121,16395,9730,4092,3367,78.25,1,125.94,245945,422219,-176274
2064-04,281678,42163,35639,5420,194884,59180,16186,26408,2822,1530,50.9,1,100.78,323841,337717,-13876
2064-05,209530,19387,22334,10951,110464,104422,14228,25350,1257,2401,184.75,0,124.83,228917,287749,-58832
2064-06,295613,19658,23352,13967,160362,110940,21557,8201,4464,2853,31.38,0,103.58,315271,338379,-23108
2064-07,218399,44313,49923,6901,117008,143116,25867,38329,555,3553,382.6,0,87.37,262712,381144,-118432
2064-08,293324,10948,27466,10553,141759,61145,14100,36657,3432,1196,110.05,1,110.21,304272,291680,12592
2064-09,289094,44291,44332,9501,195304,179244,15832,33395,2966,1078,166.27,1,134.1,333385,477608,-144223
2064-10,376909,21838,23805,8720,108525,145920,14979,39025,660,2220,587.65,1,145.87,398747,340974,57773
2064-11,242892,47932,32721,6889,101727,204820,17628,20478,1662,1524,224.54,0,126.88,290824,384263,-93439
2064-12,199492,14350,31807,12487,111646,84572,26551,31291,1368,2909,215.3,1,105.29,213842,298354,-84512
2065-01,167520,41027,38908,12691,100546,158282,8063,29668,2805,1751,103.77,0,93.53,208547,348158,-139611
2065-02,155123,11080,35698,12427,166485,141403,20049,11728,3395,2655,51.5,0,127.06,166203,387790,-221587
2065-03,278159,42817,37628,6059,120883,213077,20620,34614,1180,1261,244.12,1,119.5,320976,432881,-111905
2065-04,184931,24849,31118,8520,128668,244891,20076,15387,3595,1180,80.43,1,82.86,209780,448660,-238880
2065-05,321015,31329,42237,8801,81911,105629,6990,12304,666,602,493.0,0,88.01,352344,257872,94472
2065-06,258996,11351,37903,14051,125570,150458,12225,7281,4657,877,83.12,0,144.01,270347,347488,-77141
2065-07,466476,34382,46323,14713,92811,144754,16176,14767,4687,3091,138.33,0,101.16,500858,329544,171314
2065-08,421004,33341,37536,10092,95223,83582,25185,8743,3306,2780,57.21,1,137.1,454345,260361,193984
2065-09,159057,23870,20052,9093,195562,70826,13217,26522,3978,1119,40.24,1,84.44,182927,335272,-152345
2065-10,432441,22389,37161,11280,161992,88369,22462,26671,2310,1993,317.76,1,143.99,454830,347935,106895
2065-11,445057,39478,22801,12971,154275,231030,5304,24839,3923,2302,110.66,0,109.89,484535,451220,33315
2065-12,174478,15006,46474,14938,183445,188780,15320,25213,4667,3342,50.85,1,103.9,189484,474170,-284686
2066-01,221143,16984,46708,5953,178215,229498,28860,15810,1473,2892,161.47,0,136.89,238127,505044,-266917
2066-02,173830,13650,45105,7317,134387,135810,15726,36529,3634,3778,124.85,0,81.21,187480,374874,-187394
2066-03,484853,41047,24923,14672,163955,74678,21018,24576,4884,2317,-14.55,1,134.69,525900,323822,202078
2066-04,350351,10664,41791,13385,85396,60917,13201,11176,1864,832,188.75,1,85.28,361015,225866,135149
2066-05,137679,23884,40630,9904,93540,63864,5808,37629,4017,1513,44.3,0,104.98,161563,251375,-89812
2066-06,169633,10411,27286,11213,167596,101978,11826,20406,1740,1375,45.35,0,135.31,180044,340305,-160261
2066-07,287217,29597,24238,11419,87395,171437,18696,20208,718,3938,461.93,0,110.7,316814,333393,-16579
2066-08,473677,16653,44767,8027,198625,116787,14627,35312,2108,1466,257.41,1,96.56,490330,418145,72185
2066-09,134985,41554,23348,8934,159528,121659,9114,25553,1916,1276,70.34,1,82.31,176539,348136,-171597
2066-10,112290,13915,44447,6957,114849,200450,23912,38087,2297,3434,107.66,1,93.67,126205,428702,-302497
2066-11,151464,14773,44619,6739,93187,91309,25175,8413,3644,2311,27.38,0,93.26,166237,269442,-103205
2066-12,347039,10821,45388,7897,174676,233642,29391,20718,4720,3784,94.33,1,144.91,357860,511712,-153852
2067-01,277329,46731,48702,11206,147625,244871,25071,10921,4965,972,81.25,0,139.64,324060,488396,-164336
2067-02,115205,42970,33159,8848,129698,214643,17644,7436,4572,903,34.53,0,139.17,158175,411428,-253253
2067-03,271172,33935,47727,13044,180770,64479,24476,28258,4264,3981,76.0,1,82.75,305107,358754,-53647
2067-04,226443,15317,23031,8355,182128,125865,8423,17770,3884,2181,99.83,1,96.01,241760,365572,-123812
2067-05,360585,16893,29991,9929,113079,243494,17717,12324,2045,3755,189.7,0,113.3,377478,426534,-49056
2067-06,352838,39235,23718,9062,147501,218102,20154,18698,801,673,376.73,0,120.74,392073,437235,-45162
2067-07,249279,36513,29574,9639,144276,160967,11017,9837,1201,834,180.51,0,101.82,285792,365310,-79518
2067-08,310226,29314,32111,14739,184520,165827,5317,5076,3425,1475,53.87,1,118.44,339540,407590,-68050
2067-09,459482,15920,34387,14494,171996,119820,29428,27693,2626,497,169.89,1,111.05,475402,397818,77584
2067-10,223908,18482,44594,12693,129542,190545,8266,31636,4354,1543,-34.4,1,131.9,242390,417276,-174886
2067-11,332719,16577,21274,7803,163362,178944,18727,27212,4763,1460,42.67,0,143.64,349296,417322,-68026
2067-12,115689,13736,23563,5386,130153,81608,26351,18175,2866,2696,-10.42,1,102.62,129425,285236,-155811
2068-01,318584,47170,31549,5606,84435,184808,10720,11004,4092,545,89.78,0,127.82,365754,328122,37632
2068-02,140540,17079,49166,8207,177641,116134,8085,36072,4994,1849,33.98,0,95.79,157619,395305,-237686
2068-03,146543,34217,31073,7264,135658,144771,8813,30904,2202,3273,98.75,1,110.43,180760,358483,-177723
2068-04,141829,40152,35895,11208,136806,102430,22393,35810,4895,3979,-43.72,1,126.9,181981,344542,-162561
2068-05,449817,43925,25830,6736,161651,176669,20342,16264,853,2256,511.11,0,92.89,493742,407492,86250
2068-06,382355,31478,30016,14817,132907,165991,17587,34666,3009,2646,36.53,0,141.39,413833,395984,17849
2068-07,190280,23296,30111,6226,163432,66886,7217,22799,3502,3192,75.58,0,136.47,213576,296671,-83095
2068-08,109748,46240,41706,12789,157307,187447,9930,38504,4576,2945,27.3,1,80.38,155988,447683,-291695
2068-09,118045,21526,38222,14391,156487,56166,26706,28541,3704,551,70.32,1,101.41,139571,320513,-180942
2068-10,414839,11942,43850,13438,191378,52467,26779,26388,2958,690,104.17,1,132.44,426781,354300,72481
2068-11,209273,17131,43438,12111,120367,154841,25902,19419,687,3402,175.18,0,110.77,226404,376078,-149674
2068-12,228839,19093,36889,12301,94171,199660,13758,36903,3865,631,90.2,1,124.14,247932,393682,-145750
2069-01,320842,26955,21008,8767,146541,86467,20795,6149,4377,3394,18.48,0,85.0,347797,289727,58070
2069-02,418049,23517,43482,12834,156336,234655,21209,21930,1497,1875,249.51,0,130.27,441566,490446,-48880
2069-03,118494,34518,29568,13703,104754,109942,29241,28429,3623,1372,17.78,1,91.02,153012,315637,-162625
2069-04,115687,39615,24426,8850,166876,172580,9498,13703,1606,2529,70.73,1,83.66,155302,395933,-240631
2069-05,321078,20963,41702,12437,174997,226227,11348,28146,4037,2811,73.45,0,122.53,342041,494857,-152816
2069-06,161727,23565,22323,8268,172742,198741,16276,33062,2032,818,67.93,0,125.32,185292,451412,-266120
2069-07,346088,37163,20311,14288,192501,158595,15978,32579,2824,1292,146.0,0,126.73,383251,434252,-51001
2069-08,288408,49312,39204,7095,189241,172625,18674,36168,3762,3095,87.68,1,99.94,337720,463007,-125287
2069-09,291686,18379,29573,5232,117567,118495,26936,6841,786,812,363.33,1,90.98,310065,304644,5421
2069-10,479708,14268,26615,10390,187266,99515,21081,34141,1528,2852,245.83,1,118.71,493976,379008,114968
2069-11,125919,40819,47122,11462,140258,148585,16090,22257,4336,1081,50.32,0,81.43,166738,385774,-219036
2069-12,163993,36107,36266,5563,118112,248138,12231,26084,2800,3627,108.71,1,149.2,200100,446394,-246294
2070-01,296052,40307,35519,11999,132064,181988,13162,29506,3723,2569,72.63,0,115.13,336359,404238,-67879
2070-02,361251,32248,21302,10921,166384,54632,13128,13666,814,861,421.02,0,145.21,393499,280033,113466
2070-03,260165,14028,20870,7059,95055,213548,7290,19979,3609,963,149.03,1,83.69,274193,363801,-89608
2070-04,294047,21425,33076,7580,125941,209200,12185,11678,3836,407,34.62,1,125.75,315472,399660,-84188
2070-05,383933,48808,27452,13413,197795,89905,6898,32897,1222,989,267.62,0,97.9,432741,368360,64381
2070-06,181774,35057,26693,6859,142892,175409,18332,18815,2956,2070,104.86,0,110.25,216831,389000,-172169
2070-07,102558,27724,26169,9099,81685,213794,6427,31384,518,2392,214.82,0,136.79,130282,368558,-238276
2070-08,360764,25621,37791,14386,153996,51899,25733,32225,2472,3433,173.65,1,146.82,386385,316030,70355
2070-09,494643,19479,20732,14911,86162,109633,8771,35823,1329,3504,356.1,1,81.2,514122,276032,238090
2070-10,131274,35815,40179,13395,123091,215385,13175,21278,3203,3532,-27.41,1,102.41,167089,426503,-259414
2070-11,126224,10465,37349,5217,181564,177755,21185,33098,850,2440,120.04,0,115.82,136689,456168,-319479
2070-12,183131,29837,22693,9010,80702,237592,17030,39842,718,3662,271.3,1,98.1,212968,406869,-193901
2071-01,368962,41673,31669,7659,124211,160186,16889,10429,994,534,301.73,0,148.51,410635,351043,59592
2071-02,206624,29165,48719,5873,81375,136864,26117,12355,4864,3480,0.28,0,92.39,235789,311303,-75514
2071-03,289525,23091,32012,14953,170369,218787,9335,19373,1415,3140,131.28,1,97.3,312616,464829,-152213
2071-04,110898,49489,44872,5469,197100,114732,6227,29979,1729,765,140.7,1,93.92,160387,398379,-237992
2071-05,404436,15679,46467,5313,85865,233422,15917,36681,4427,1650,125.98,0,123.21,420115,423665,-3550
2071-06,403244,19153,31386,14643,90778,203173,18225,33285,1860,1690,207.34,0,146.41,422397,391490,30907
2071-07,384465,39192,45139,6177,152586,203896,29251,21689,4234,551,114.76,0,133.54,423657,458738,-35081
2071-08,457163,34894,43710,12669,198013,99968,27188,39256,2761,1118,132.43,1,100.98,492057,420804,71253
2071-09,334639,34504,38616,14166,119512,223095,23599,30599,3883,1322,97.91,1,96.46,369143,449587,-80444
2071-10,406773,35313,44051,9851,91442,222562,20066,28915,2254,1509,198.0,1,145.0,442086,416887,25199
2071-11,248040,21742,33495,14800,98665,166472,27661,10738,573,3055,402.07,0,88.52,269782,351831,-82049
2071-12,320036,32219,35551,7182,120549,76653,25919,21067,501,3180,598.68,1,104.63,352255,286921,65334
2072-01,436573,39107,35866,14157,174154,177112,11346,25769,4403,1209,158.08,0,123.97,475680,438404,37276
2072-02,490934,27484,38821,9592,197152,173057,7758,12569,1077,1722,449.27,0,96.98,518418,438949,79469
2072-03,370897,29986,28923,13868,139957,64222,28486,33910,781,3447,496.54,1,104.72,400883,309366,91517
2072-04,343453,32608,24899,13560,128708,51771,16285,8758,2614,3422,96.8,1,113.83,376061,243981,132080
2072-05,320181,40911,23833,10073,109779,242206,19419,17807,4484,865,154.64,0,117.77,361092,423117,-62025
2072-06,212736,49208,24279,9575,107986,200348,17114,15673,1638,3794,90.36,0,135.57,261944,374975,-113031
2072-07,294016,22707,28002,5432,184918,144048,14674,6603,2509,2773,113.55,0,125.89,316723,383677,-66954
2072-08,394837,43121,43489,6605,190622,72048,21273,36105,3821,3968,56.82,1,137.91,437958,370142,67816
2072-09,470899,44447,43398,10295,156291,77834,6399,18014,584,1588,825.03,1,108.64,515346,312231,203115
2072-10,103858,21811,36663,11054,121129,179738,25607,14858,1431,3399,99.19,1,94.44,125669,389049,-263380
2072-11,459512,42059,37565,11165,193805,242207,19544,17257,4094,2069,169.01,0,145.77,501571,521543,-19972
2072-12,316007,27834,45704,13957,193829,152286,13189,30973,1998,2671,99.62,1,99.72,343841,449938,-106097
2073-01,291960,15421,29720,14563,189294,73299,7045,18508,1408,2590,85.74,0,147.49,307381,332429,-25048
2073-02,220306,36547,27881,8357,193656,193192,15261,15503,2673,3935,1.59,0,139.99,256853,453850,-196997
2073-03,320418,21357,24247,5581,168894,119319,28636,18401,4462,3449,101.72,1,137.3,341775,365078,-23303
2073-04,424878,37608,21389,12648,177726,134991,18542,13558,4759,3716,13.11,1,115.4,462486,378854,83632
2073-05,426537,35012,49020,6190,192638,247335,21709,12393,3638,2826,123.04,0,118.79,461549,529285,-67736
2073-06,144076,42212,28848,10355,99494,91606,24257,6470,4690,2223,79.53,0,93.28,186288,261030,-74742
2073-07,407691,33384,31658,11868,95618,164378,9032,27565,2029,1394,198.4,0,126.21,441075,340119,100956
2073-08,368283,34844,46858,9294,82282,225171,25129,12434,4099,3279,77.47,1,142.25,403127,401168,1959
2073-09,406883,19747,48035,14759,139910,57072,8237,10479,2091,3007,234.95,1,98.92,426630,278492,148138
2073-10,450849,35678,20330,5388,140604,132037,24813,38119,4671,1658,81.72,1,112.89,486527,361291,125236
2073-11,293621,25592,38329,8384,169978,147576,19754,24937,4220,3778,53.94,0,139.76,319213,408958,-89745
2073-12,416367,35816,21631,9441,86855,238409,16894,27280,3324,2938,56.69,1,112.35,452183,400510,51673
2074-01,141447,16778,23496,8186,189018,145487,11988,38582,693,3559,224.3,0,129.48,158225,416757,-258532
2074-02,304656,12994,49732,7152,159970,174767,8819,23703,4563,2109,17.18,0,147.51,317650,424143,-106493
2074-03,279320,22338,34405,10867,105517,182042,21545,32995,3095,2225,88.28,1,116.78,301658,387371,-85713
2074-04,221715,42932,22075,14043,80112,162362,16272,25097,4020,2831,101.82,1,106.68,264647,319961,-55314
2074-05,419713,36215,25450,10158,135126,104558,6838,9712,2850,1967,95.59,0,123.53,455928,291842,164086
2074-06,254126,47255,46809,14934,132585,173768,13336,16820,1544,3436,101.29,0,142.96,301381,398252,-96871
2074-07,356183,11862,21618,6632,132135,159511,26163,11031,2663,374,137.47,0,132.43,368045,357090,10955
2074-08,228817,20298,41094,7738,160774,111115,10604,16118,4778,3724,91.96,1,133.86,249115,347443,-98328
2074-09,233885,44563,21180,7890,99344,226857,27710,39742,3306,2782,88.3,1,145.04,278448,422723,-144275
2074-10,425886,30733,48824,5344,100709,180047,17240,32080,3643,3234,150.16,1,142.41,456619,384244,72375
2074-11,239187,11826,28131,9344,167675,168120,19320,38914,706,510,324.99,0,94.82,251013,431504,-180491
2074-12,146969,49678,43035,9918,146153,234901,29156,15496,1457,2963,6.85,1,89.35,196647,478659,-282012
2075-01,377528,19241,28159,14692,194279,186677,18795,5625,1736,3168,301.93,0,143.41,396769,448227,-51458
2075-02,243516,20738,34226,8205,181501,76235,26952,29683,2697,1624,108.42,0,142.2,264254,356802,-92548
2075-03,390140,45989,28907,12191,132006,228022,11146,5625,1184,3488,315.74,1,85.29,436129,417897,18232
2075-04,293646,42355,43560,8712,167885,64980,5111,17222,4828,1751,86.11,1,132.31,336001,307470,28531
2075-05,164968,32134,45244,14459,152315,199692,23704,13149,4407,2107,82.24,0,108.57,197102,448563,-251461
2075-06,393072,16172,44418,12845,110105,235511,9225,14099,3158,544,92.39,0,114.57,409244,426203,-16959
2075-07,299943,34685,38875,12431,144721,174981,29429,31000,3757,1464,143.32,0,107.03,334628,431437,-96809
2075-08,422748,13898,35064,13915,142603,248897,27600,38446,3882,2468,116.85,1,131.86,436646,506525,-69879
2075-09,165935,23019,40200,14071,165329,246417,26753,15868,2222,1825,31.95,1,115.05,188954,508638,-319684
2075-10,146523,36058,22428,5361,188430,208087,28154,13715,540,2341,296.73,1,92.55,182581,466175,-283594
2075-11,139750,34735,40380,7865,85625,51730,22123,14321,3361,3658,13.7,0,106.5,174485,222044,-47559
2075-12,359747,24143,47075,9600,121257,177349,16896,39083,2689,1376,132.58,1,145.77,383890,411260,-27370
2076-01,325275,34729,33047,7979,143444,227823,5262,12128,3287,2364,125.53,0,119.56,360004,429683,-69679
2076-02,462148,33175,39927,13365,186766,185307,13075,28901,2933,1663,109.56,0,104.81,495323,467341,27982
2076-03,120773,21227,36690,13954,148635,70426,20772,17180,881,1407,191.32,1,103.12,142000,307657,-165657
2076-04,172149,17123,27158,8792,80171,188165,20826,32174,1675,1413,121.57,1,137.23,189272,357286,-168014
2076-05,399191,22292,22194,7717,95153,87559,14250,13860,2176,2520,185.05,0,81.76,421483,240733,180750
2076-06,392840,40719,27091,13456,142310,170894,23230,31377,4674,1819,124.2,0,140.55,433559,408358,25201
2076-07,459081,15128,39863,8631,140356,126521,26167,24857,1316,622,384.01,0,85.34,474209,366395,107814
2076-08,205204,23910,33670,9833,137373,199792,27861,35754,3592,1953,50.86,1,83.42,229114,444283,-215169
2076-09,281538,48229,22018,6016,177463,147072,20417,31187,1715,3261,245.59,1,104.94,329767,404173,-74406
2076-10,270165,19403,22040,10162,152285,91953,5763,27927,4560,2656,0.69,1,139.77,289568,310130,-20562
2076-11,400208,12053,37544,6915,131858,217843,7721,9358,1322,519,324.15,0,146.66,412261,411239,1022
2076-12,465658,24968,49746,13207,98915,65761,21480,15973,1192,3815,360.02,1,133.93,490626,265082,225544
2077-01,104679,44575,21044,14824,116644,117631,25964,16325,4293,1357,-24.96,0,111.84,149254,312432,-163178
2077-02,136677,23788,20192,8675,111392,157456,5830,11929,3221,310,13.27,0,112.92,160465,315474,-155009
2077-03,400561,36965,25532,9878,192660,158161,10055,5797,1035,2833,440.79,1,86.91,437526,402083,35443
2077-04,436413,37212,36697,7264,165232,105020,12366,9561,3562,3684,124.99,1,125.91,473625,336140,137485
2077-05,409515,10068,44730,6776,134552,245677,16736,21375,1255,3821,356.52,0,137.96,419583,469846,-50263
2077-06,277167,22431,34913,13918,99251,230215,10337,17201,4637,550,26.01,0,87.35,299598,405835,-106237
2077-07,323039,25575,30055,5182,134828,72973,14288,24837,4982,349,82.77,0,148.78,348614,282163,66451
2077-08,446632,46152,28028,14982,145357,59264,28142,19356,1655,1244,271.59,1,88.34,492784,295129,197655
2077-09,171092,43227,42350,9747,140831,234969,29376,12168,3815,1435,49.17,1,139.29,214319,469441,-255122
2077-10,241201,28878,49133,14157,111285,185579,10621,33759,1933,1873,153.8,1,141.63,270079,404534,-134455
2077-11,478439,49307,31505,7022,126067,56858,13571,7226,3424,2159,134.8,0,100.16,527746,242249,285497
2077-12,187158,15920,29528,9557,121821,127301,14815,30076,2985,2193,64.65,1,146.48,203078,333098,-130020
2078-01,199911,14695,38333,9952,164880,239185,16681,7738,3163,3360,24.91,0,131.01,214606,476769,-262163
2078-02,368242,13325,26137,10886,170952,116334,28720,31919,4625,642,157.19,0,121.75,381567,384948,-3381
2078-03,446635,46578,46333,10731,111589,193614,20390,35505,3096,531,234.3,1,98.75,493213,418162,75051
2078-04,179383,30203,42787,14318,99927,173964,16011,32693,2954,1743,30.33,1,146.54,209586,379700,-170114
2078-05,394585,48439,45151,6920,190003,236255,16867,5159,3888,3369,29.63,0,123.5,443024,500355,-57331
2078-06,333718,21139,20920,7622,84243,205252,6389,38425,4774,2122,217.28,0,98.95,354857,362851,-7994
2078-07,156933,19835,24899,14664,186010,54044,21132,24345,4637,3375,122.29,0,86.72,176768,325094,-148326
2078-08,266045,24091,36304,14028,119154,193233,10847,33955,3384,1124,131.55,1,114.7,290136,407521,-117385
2078-09,357710,44716,24121,11621,163862,126666,24796,11128,1891,3014,151.06,1,142.22,402426,362194,40232
2078-10,385217,34417,26921,10831,170564,67394,14728,7980,2033,2100,205.77,1,117.24,419634,298418,121216
2078-11,436313,39798,45550,5542,85638,194024,14072,9812,2025,3794,178.95,0,92.66,476111,354638,121473
2078-12,217752,31407,20524,6621,95663,246179,6096,16305,3568,3894,61.07,1,105.74,249159,391388,-142229
2079-01,359086,34041,28882,8946,171002,242800,19164,7317,2565,961,155.86,0,129.08,393127,478111,-84984
2079-02,374784,13733,27061,14026,100635,239287,14028,6271,4725,548,45.5,0,88.91,388517,401308,-12791
2079-03,403789,34400,42838,12609,174370,238353,6668,22515,2686,1880,95.31,1,116.65,438189,497353,-59164
2079-04,138432,46528,41662,11133,89346,133431,26521,11392,1787,815,21.39,1,100.94,184960,313485,-128525
2079-05,401878,38554,20536,6694,123482,180116,9492,6087,2584,866,158.43,0,97.02,440432,346407,94025
2079-06,404694,13255,38554,14378,183538,220469,29023,37987,2503,1856,99.62,0,102.23,417949,523949,-106000
2079-07,122323,39852,20591,14760,94959,102540,13388,14853,4600,2665,52.27,0,109.04,162175,261091,-98916
2079-08,276994,18182,44647,10327,124210,68389,10245,33357,4724,3724,111.86,1,132.54,295176,291175,4001
2079-09,373879,30755,33050,6723,188308,179132,28905,22567,4428,2316,157.33,1,125.35,404634,458685,-54051
2079-10,351214,47770,24505,5546,196845,183421,7590,17443,2446,3478,145.85,1,140.37,398984,435350,-36366
2079-11,106343,26396,45361,10637,177345,168150,19525,20084,3548,604,-2.85,0,88.22,132739,441102,-308363
2079-12,457627,33289,33974,9188,103914,153980,17356,20194,1543,1412,335.92,1,117.81,490916,338606,152310
2080-01,186977,39049,29248,11079,168840,138552,24063,7748,3888,2947,149.31,0,147.18,226026,379530,-153504
2080-02,477464,23255,20018,6780,140060,88152,29785,30996,4397,2660,62.64,0,110.79,500719,315791,184928
2080-03,267173,38721,32714,5687,178544,112938,11354,12299,4366,1634,20.6,1,101.29,305894,353536,-47642
2080-04,157712,45593,30633,9049,184424,143386,18462,36373,4468,2144,24.79,1,124.11,203305,422327,-219022
2080-05,355513,32666,43765,9844,158794,236041,18694,26386,2164,3059,224.05,0,113.91,388179,493524,-105345
2080-06,296055,13916,49644,6398,80004,62483,27823,10289,4674,2027,-15.48,0,87.06,309971,236641,73330
2080-07,137956,42227,43507,9739,120365,91652,14831,30282,2977,474,-0.24,0,142.08,180183,310376,-130193
2080-08,426420,45786,23550,7448,133192,97664,24192,15911,1781,1159,290.18,1,116.12,472206,301957,170249
2080-09,369282,29774,24051,7641,162674,99680,24495,10770,4424,1935,164.2,1,147.48,399056,329311,69745
2080-10,369106,44537,27065,8338,187895,87681,13304,22188,3589,327,83.73,1,135.11,413643,346471,67172
2080-11,134031,41955,39591,14118,101034,132559,12540,16426,3827,300,57.4,0,111.5,175986,316268,-140282
2080-12,106024,48632,45961,10169,113297,91351,29591,37838,3356,980,47.56,1,135.25,154656,328207,-173551
2081-01,160291,38620,42937,5233,121342,178380,26637,36592,4908,2249,53.36,0,91.28,198911,411121,-212210
2081-02,129001,43574,42941,10642,177468,190683,13347,24325,739,2456,157.35,0,146.67,172575,459406,-286831
2081-03,371834,28182,30148,12112,110965,210673,28073,13294,1146,3411,334.69,1,92.7,400016,405265,-5249
2081-04,489592,21672,21890,10092,122325,182168,17347,26824,888,2074,667.79,1,95.92,511264,380646,130618
2081-05,224836,39028,35582,13746,159996,161542,22741,28640,3014,2352,32.85,0,92.65,263864,422247,-158383
2081-06,192275,42854,23386,13876,89761,208184,13954,20551,3032,1795,33.4,0,149.37,235129,369712,-134583
2081-07,164560,37393,44927,5093,178712,108856,16353,30004,4903,2994,-3.6,0,138.81,201953,383945,-181992
2081-08,328374,41002,30509,10188,190437,127964,9199,33210,605,759,545.98,1,136.36,369376,401507,-32131
2081-09,354145,13125,23391,10667,140226,85959,18194,6451,2915,468,119.16,1,91.84,367270,284888,82382
2081-10,172626,41671,41678,12873,133842,235405,23881,18593,3963,3067,-45.46,1,82.59,214297,466272,-251975
2081-11,279953,18008,31155,13938,187517,128581,5259,29207,2639,630,91.24,0,120.3,297961,395657,-97696
2081-12,290875,38099,24193,13355,191024,199121,19937,16137,823,2944,304.19,1,109.54,328974,463767,-134793
2082-01,221107,25023,25908,7904,178002,67232,7230,35965,3264,1814,145.24,0,143.74,246130,322241,-76111
2082-02,194574,22694,20728,7002,160995,222631,11106,14441,1645,373,108.04,0,135.1,217268,436903,-219635
2082-03,441946,28183,25310,12564,156195,54055,7600,28915,3196,3348,163.81,1,123.11,470129,284639,185490
2082-04,343154,16664,22267,5234,82277,87339,13346,29299,1057,1220,362.51,1,128.43,359818,239762,120056
2082-05,488070,32749,39749,7916,128183,135376,16930,24612,4593,3868,76.23,0,145.5,520819,352766,168053
2082-06,213096,26059,36261,8343,98349,112430,21737,35645,2203,1319,15.52,0,105.27,239155,312765,-73610
2082-07,314912,31337,36742,9353,124760,85591,19551,8396,2128,2936,64.5,0,126.91,346249,284393,61856
2082-08,374478,22607,35819,9608,148486,216515,15628,29309,508,2052,738.2,1,131.44,397085,455365,-58280
2082-09,129813,20121,42782,12703,180793,157315,28757,5202,1531,458,169.7,1,123.3,149934,427552,-277618
2082-10,172173,39524,35911,7283,112887,132350,19300,19670,4614,2205,19.55,1,116.56,211697,327401,-115704
2082-11,354341,11497,38387,13091,127290,169208,24253,30010,858,2869,391.81,0,90.14,365838,402239,-36401
2082-12,474257,18413,42112,10362,117657,241574,27444,20019,4202,819,163.91,1,91.69,492670,459168,33502
2083-01,363051,43643,36443,13756,88261,239038,5522,9868,4934,1399,97.94,0,103.48,406694,392888,13806
2083-02,450623,28868,46926,14197,196499,224652,7972,10712,2790,515,146.68,0,130.72,479491,500958,-21467
2083-03,347449,21537,23865,6317,101501,133720,24519,31441,1732,2595,318.03,1,132.55,368986,321363,47623
2083-04,115539,37326,46740,9897,198786,176079,21475,34408,3259,2215,-16.13,1,139.02,152865,487385,-334520
2083-05,112025,35310,42049,9024,166958,119015,28945,12493,2175,1454,19.72,0,88.32,147335,378484,-231149
2083-06,461224,12924,48772,7516,173642,62804,6842,6402,710,691,572.46,0,140.9,474148,305978,168170
2083-07,272789,49275,43931,7411,151727,249172,7209,22572,4916,2776,77.77,0,107.36,322064,482022,-159958
2083-08,398202,32865,44703,8594,115786,194393,15614,28926,1487,1253,269.41,1,112.38,431067,408016,23051
2083-09,248871,49117,41886,7519,105552,133101,7171,5361,2795,2399,63.98,1,134.75,297988,300590,-2602
2083-10,302000,46230,33356,12498,82976,211831,25356,24875,4897,1859,-7.74,1,108.13,348230,390892,-42662
2083-11,204904,35034,32335,10994,192890,115772,19129,15136,1215,2954,121.46,0,103.56,239938,386256,-146318
2083-12,349676,42525,47995,7654,122093,188340,24823,22697,731,2924,511.36,1,122.99,392201,413602,-21401
2084-01,484899,17017,41624,5507,81407,190114,27039,13646,2228,3383,219.82,0,121.08,501916,359337,142579
2084-02,334883,47404,33400,12723,98143,204078,5752,6041,1592,983,192.81,0,91.72,382287,360137,22150
2084-03,474126,48896,37939,11083,182368,209157,22195,36350,2213,2365,259.31,1,137.31,523022,499092,23930
2084-04,116496,28658,34605,5452,174740,184645,27181,5056,3089,2849,5.13,1,81.23,145154,431679,-286525
2084-05,418693,28443,40714,6098,98555,129714,5287,9991,4338,860,161.44,0,95.68,447136,290359,156777
2084-06,252512,11011,26001,10710,164383,201934,19721,33124,1118,1873,241.6,0,140.91,263523,455873,-192350
2084-07,488980,41740,26121,5866,110728,201833,6539,15098,4929,3285,118.14,0,138.34,530720,366185,164535
2084-08,126030,44085,24673,6965,189088,98897,5755,12181,540,3004,340.3,1,130.63,170115,337559,-167444
2084-09,164898,29948,43505,8321,149435,192145,14406,29349,1547,1047,47.97,1,102.12,194846,437161,-242315
2084-10,358431,36443,28199,8383,86115,90323,29887,16057,4661,677,1.33,1,113.96,394874,258964,135910
2084-11,480392,49783,33202,9747,87549,83696,26841,11751,4573,3739,188.34,0,88.34,530175,252786,277389
2084-12,278446,16776,22198,14827,94125,53362,26425,28354,957,2409,250.89,1,98.08,295222,239291,55931
2085-01,322506,13380,49587,13440,117745,153808,27693,29855,1522,1231,272.78,0,93.52,335886,392128,-56242
2085-02,246254,24320,32438,9580,163165,132180,28007,15925,4488,3999,57.6,0,138.17,270574,381295,-110721
2085-03,250965,47229,30035,13951,82887,113243,6796,13288,3601,2648,120.41,1,117.66,298194,260200,37994
2085-04,176387,37847,49423,6981,107829,182764,17361,20677,2935,2663,25.55,1,97.48,214234,385035,-170801
2085-05,179818,30350,22225,10705,89538,196689,7479,35983,1395,1908,150.77,0,111.89,210168,362619,-152451
2085-06,196015,32292,42293,12367,112999,63072,24408,11532,3260,808,117.86,0,109.34,228307,266671,-38364
2085-07,339926,21924,28819,10537,173164,211207,10722,15486,580,3486,521.37,0,84.1,361850,449935,-88085
2085-08,252502,28115,33016,10580,108747,154008,13663,23622,1990,835,193.99,1,84.68,280617,343636,-63019
2085-09,394103,29730,34346,13050,137363,125625,18507,26994,1718,3181,255.23,1,144.1,423833,355885,67948
2085-10,450525,48129,41379,5196,92980,53034,23934,11615,2962,2507,148.41,1,133.47,498654,228138,270516
2085-11,467670,12413,25523,14457,192159,69291,23029,28663,4473,1591,84.72,0,93.44,480083,353122,126961
2085-12,275771,45213,47543,12410,124363,190763,12507,30883,2315,1362,-7.14,1,88.92,320984,418469,-97485
2086-01,438728,45868,40182,10446,189569,67946,22438,27725,4808,3331,68.78,0,142.69,484596,358306,126290
2086-02,427280,42499,35504,9495,135978,195149,27489,36263,3176,3802,143.27,0,115.13,469779,439878,29901
2086-03,177107,31895,36084,9798,149648,187138,7075,10621,4278,1650,89.87,1,93.08,209002,400364,-191362
2086-04,337743,16914,21168,7949,168530,130776,13706,33431,1114,1173,386.16,1,128.72,354657,375560,-20903
2086-05,118490,31202,37774,6928,109175,209610,5752,28388,2721,1811,53.4,0,115.96,149692,397627,-247935
2086-06,260291,32505,49986,14797,165057,124111,27244,33560,3848,3095,136.88,0,133.57,292796,414755,-121959
2086-07,481409,18800,35474,12175,105204,101417,9950,16910,1165,2759,322.22,0,96.53,500209,281130,219079
2086-08,453295,34011,39593,13369,187481,184659,15756,21663,1986,3726,301.46,1,114.39,487306,462521,24785
2086-09,103369,30424,32552,11376,107263,235972,11462,29585,4911,1233,38.25,1,117.12,133793,428210,-294417
2086-10,193167,24531,20641,6206,183932,197143,26688,21005,2174,2043,55.22,1,106.47,217698,455615,-237917
2086-11,251977,41921,26048,8861,106256,96279,11159,38179,2136,1261,152.25,0,130.98,293898,286782,7116
2086-12,169414,31239,39353,10141,159441,57932,17343,35204,2636,1605,124.83,1,135.75,200653,319414,-118761
2087-01,307402,44662,31658,6403,176995,176543,28875,29160,4749,884,21.65,0,110.16,352064,449634,-97570
2087-02,328812,26641,25848,9400,159031,56789,11554,6624,1848,2072,88.65,0,89.62,355453,269246,86207
2087-03,434918,41959,37696,6902,111743,55710,25453,6733,3040,3943,182.63,1,101.41,476877,244237,232640
2087-04,365391,49526,48519,10714,144133,208710,15280,24406,3629,359,131.43,1,85.12,414917,451762,-36845
2087-05,355875,44956,33262,11620,165925,218789,7931,20214,3953,1729,34.97,0,115.39,400831,457741,-56910
2087-06,155480,18897,41904,13972,82540,212738,13787,38800,1477,3165,156.51,0,81.89,174377,403741,-229364
2087-07,289577,23494,47253,11892,91778,235262,21271,20156,3522,3471,111.59,0,124.57,313071,427612,-114541
2087-08,254085,23386,47937,10371,190284,145718,22606,12964,1349,3349,134.6,1,111.32,277471,429880,-152409
2087-09,262671,21115,46639,12377,134647,86015,9545,35332,3174,321,65.18,1,106.03,283786,324555,-40769
2087-10,161711,10686,34870,14272,165981,212703,20696,35095,4083,3006,31.18,1,137.64,172397,483617,-311220
2087-11,445641,19018,45952,6319,122422,90389,8288,20506,2200,2878,228.99,0,103.24,464659,293876,170783
2087-12,299273,18814,48191,11779,164707,102749,21072,31869,3023,2478,230.02,1,107.76,318087,380367,-62280
2088-01,397122,22977,48257,8285,111119,154849,10935,36202,3347,534,127.29,0,104.98,420099,369647,50452
2088-02,214716,25825,20904,13425,180459,222869,9037,37592,4470,2160,111.71,0,138.7,240541,484286,-243745
2088-03,453651,28922,42236,7573,181868,120889,25243,38912,2624,3565,108.9,1,130.89,482573,416721,65852
2088-04,459367,28010,39565,7333,196292,186124,27538,16777,2458,3351,176.74,1,146.28,487377,473629,13748
2088-05,414751,31380,41991,8229,136706,248651,19289,8078,1082,3237,339.52,0,99.76,446131,462944,-16813
2088-06,265342,37886,34736,10844,118110,157830,12012,14890,519,1076,483.98,0,111.22,303228,348422,-45194
2088-07,428620,34121,39912,10574,120694,121122,8199,19470,2710,3492,211.14,0,141.01,462741,319971,142770
2088-08,391835,28164,23822,13054,106532,204676,26637,24900,2515,2406,157.49,1,136.5,419999,399621,20378
2088-09,327834,36430,40334,13899,106350,223727,6380,12303,3685,614,34.15,1,146.56,364264,402993,-38729
2088-10,402572,31649,36444,14928,132211,194199,8224,32481,894,959,450.42,1,80.92,434221,418487,15734
2088-11,450335,21484,26876,5141,134564,159719,20795,39443,778,432,568.01,0,107.58,471819,386538,85281
2088-12,134193,32041,36587,5847,121819,51540,19608,19045,4704,914,-26.59,1,98.69,166234,254446,-88212
2089-01,240580,43456,49903,12155,107882,68212,10368,14697,1382,335,63.12,0,118.19,284036,263217,20819
2089-02,388891,31757,37673,10549,138957,93156,11126,38806,3763,2461,96.25,0,82.0,420648,330267,90381
2089-03,241835,48690,42413,7249,131526,156026,5621,27978,2467,2366,99.54,1,93.1,290525,370813,-80288
2089-04,388986,20472,45951,8466,170217,71327,6507,12776,1775,2019,207.32,1,108.69,409458,315244,94214
2089-05,414777,35253,46796,14771,90771,116478,16581,39775,3808,2882,57.78,0,139.68,450030,325172,124858
2089-06,312692,46434,21360,10054,193943,241549,7777,29059,3656,2605,98.1,0,127.08,359126,503742,-144616
2089-07,177476,35967,44933,8993,107385,97037,25168,38460,2117,1131,81.61,0,130.38,213443,321976,-108533
2089-08,168898,34507,33969,10231,190280,206275,9705,22395,3171,2106,85.01,1,121.67,203405,472855,-269450
2089-09,193391,28681,44440,11299,89259,174705,5984,13039,2182,2625,133.9,1,100.09,222072,338726,-116654
2089-10,249243,19084,46434,13012,185716,104405,25689,29424,1755,583,74.48,1,106.14,268327,404680,-136353
2089-11,414988,20416,39811,11864,193893,79072,25680,36669,2577,820,249.94,0,140.19,435404,386989,48415
2089-12,321201,25661,41571,10286,106851,120817,6514,10301,4531,1276,83.41,1,103.91,346862,296340,50522
2090-01,455627,35894,41081,6719,130697,193047,24538,24259,4075,541,186.67,0,96.11,491521,420341,71180
2090-02,303393,48026,47048,5111,86708,192585,8676,18885,1981,1908,204.25,0,97.04,351419,359013,-7594
2090-03,350583,47637,31419,11044,99404,110488,12880,36040,3975,3182,144.48,1,98.76,398220,301275,96945
2090-04,403694,40809,37849,11037,140951,52228,28279,34163,4168,2155,103.75,1,93.62,444503,304507,139996
2090-05,432344,45035,20430,12190,98498,86883,26833,28782,4035,1979,100.7,0,90.71,477379,273616,203763
2090-06,308581,38188,42193,12467,179665,90152,28636,32028,2497,3939,106.3,0,143.73,346769,385141,-38372
2090-07,142748,42474,35098,14303,122938,176584,19116,28973,2651,3272,72.61,0,112.33,185222,397012,-211790
2090-08,489475,21064,26246,12344,90294,86098,19898,28056,3861,802,174.4,1,89.22,510539,262936,247603
2090-09,324572,40592,39096,11502,92140,140928,28838,20756,2277,3594,154.26,1,81.51,365164,333260,31904
2090-10,306029,46971,29465,6318,184160,108653,19094,38083,2329,1987,89.87,1,92.52,353000,385773,-32773
2090-11,177959,47776,39890,11261,97459,249427,29134,8956,723,3865,217.33,0,110.63,225735,436127,-210392
2090-12,141909,14989,32812,9950,147864,191890,22766,27761,1750,370,136.97,1,115.46,156898,433043,-276145
2091-01,428590,42429,32619,13083,169555,94767,13622,32903,1294,2615,332.22,0,133.61,471019,356549,114470
2091-02,305402,30542,33047,12773,91356,143802,17987,35654,3918,3080,20.47,0,98.96,335944,334619,1325
2091-03,451870,38895,33096,13727,112918,221523,29138,33980,3274,3030,40.99,1,100.2,490765,444382,46383
2091-04,148257,40496,35375,6311,108103,147424,13102,17232,1562,2762,45.16,1,132.54,188753,327547,-138794
2091-05,168379,34441,43154,5554,177684,62300,22396,7000,4935,1682,54.86,0,82.11,202820,318088,-115268
2091-06,238734,17823,27809,8101,115626,213091,20533,36901,4373,917,83.52,0,94.71,256557,422061,-165504
2091-07,461675,36028,39215,8444,181622,155112,19837,36403,3067,2635,167.66,0,127.96,497703,440633,57070
2091-08,445294,41386,21700,5081,117240,239479,24880,24405,4957,3205,68.46,1,105.31,486680,432785,53895
2091-09,321520,36519,30189,5440,108610,109720,23385,39958,4992,2252,53.07,1,121.95,358039,317302,40737
2091-10,298053,11162,28152,7005,129833,220658,15129,20129,4204,3678,98.29,1,143.3,309215,420906,-111691
2091-11,491168,18872,45196,6949,86823,70743,10742,8389,587,2165,929.81,0,85.39,510040,228842,281198
2091-12,301723,20190,35540,9506,90762,181748,27980,34688,4215,2123,64.79,1,133.94,321913,380224,-58311
2092-01,436268,14515,30715,14765,167986,234852,9475,18768,3458,1434,125.72,0,148.27,450783,476561,-25778
2092-02,499610,12647,41249,12804,166693,119724,13579,24836,2884,1746,212.72,0,127.96,512257,378885,133372
2092-03,273149,29745,36799,6082,90902,169846,6068,11095,1462,2907,277.77,1,101.53,302894,320792,-17898
2092-04,396767,43339,31971,7301,133577,61213,15570,24084,1662,316,311.74,1,100.7,440106,273716,166390
2092-05,210833,23227,26706,5733,136697,219091,11433,7583,1969,3192,153.9,0,140.32,234060,407243,-173183
2092-06,284244,47512,29816,6331,142232,65421,5558,13834,2652,470,121.36,0,97.14,331756,263192,68564
2092-07,135891,21286,48157,9315,174276,96473,16066,17656,713,3007,175.18,0,141.35,157177,361943,-204766
2092-08,319113,46097,28006,11813,118115,115277,18378,11537,2080,2116,83.29,1,99.85,365210,303126,62084
2092-09,276640,34492,47166,13133,142293,203466,13322,7392,3681,2450,31.3,1,91.18,311132,426772,-115640
2092-10,115154,12543,42130,5981,90999,173381,8416,31230,3078,3139,54.69,1,139.06,127697,352137,-224440
2092-11,109800,11265,22363,6717,110903,125161,13840,10401,2871,1622,34.59,0,100.66,121065,289385,-168320
2092-12,278670,23192,42192,5307,117002,196076,16833,5322,4606,1366,108.11,1,96.12,301862,382732,-80870
2093-01,280525,35500,37040,10659,184675,132113,9536,15247,1094,2547,309.04,0,95.15,316025,389270,-73245
2093-02,496876,19694,39505,10813,124387,178671,8340,15242,1293,2408,403.95,0,87.12,516570,376958,139612
2093-03,343813,32050,36348,14504,184517,203187,7892,9967,4590,1420,-5.59,1,92.59,375863,456415,-80552
2093-04,188919,30414,45892,13598,189152,229838,27271,14165,2182,1797,49.08,1,116.89,219333,519916,-300583
