Month-Year,Sales Revenue (₹),Service Fees (₹),Rent (₹),Utilities (₹),Salaries & Wages (₹),Raw Materials / Inventory (₹),Transportation / Logistics (₹),Loan Repayments & Interest (₹),Number of Orders,Customers,Average Order Value,Seasonality_Flag,Fuel Price Index,Total Income (₹),Total Expenses (₹),Net Cash Flow (₹)
2010-01,115841,44925,35802,11484,172267,167314,28048,31724,3247,3714,47.96,0,147.09,160766,446639,-285873
2010-02,442813,12011,30418,5675,90967,112206,16264,39003,1429,2184,253.56,0,112.71,454824,294533,160291
2010-03,238107,19990,28847,14722,133778,130140,27715,29995,3513,2427,60.37,1,102.72,258097,365197,-107100
2010-04,448831,33591,32135,5686,99071,81610,9897,8385,950,664,482.06,1,122.83,482422,236784,245638
2010-05,490683,42476,24191,8616,107790,109806,15783,34152,2247,916,211.96,0,80.6,533159,300338,232821
2010-06,255542,42764,36753,8269,117746,227737,19876,39365,2367,638,74.35,0,91.93,298306,449746,-151440
2010-07,338390,44455,33506,13966,187294,248496,25569,21370,2945,623,164.54,0,116.52,382845,530201,-147356
2010-08,230891,20063,33310,13575,105229,235532,24461,17237,1902,2505,112.87,1,133.31,250954,429344,-178390
2010-09,495535,20186,29854,6957,141525,64048,18023,16106,1715,2706,358.53,1,94.49,515721,276513,239208
2010-10,479237,27307,46925,14153,179573,93458,13191,11288,3089,3687,209.36,1,137.65,506544,358588,147956
2010-11,182550,16746,48873,14083,101563,127083,20826,5945,4444,1960,-6.85,0,84.65,199296,318373,-119077
2010-12,112327,22156,47304,12623,167965,206009,29306,19874,4710,1153,44.33,1,121.06,134483,483081,-348598
2011-01,392664,12071,24797,6573,155102,58222,26681,29069,2418,1994,175.39,0,90.12,404735,300444,104291
2011-02,369731,24292,23691,8359,187981,244390,10363,5480,3314,1193,133.96,0,135.11,394023,480264,-86241
2011-03,245838,36793,23718,8700,146595,86946,26895,9061,2315,687,124.88,1,149.26,282631,301915,-19284
2011-04,298220,19812,41539,8389,81121,215015,26626,11524,3942,799,49.63,1,134.23,318032,384214,-66182
2011-05,316783,15535,30270,5518,194333,122722,12767,14610,1780,1254,176.66,0,137.48,332318,380220,-47902
2011-06,454917,46435,39184,12012,97319,152905,21469,23707,4140,3617,168.22,0,113.97,501352,346596,154756
2011-07,199290,48187,22357,8070,92711,181498,17462,13486,2731,2734,105.36,0,137.34,247477,335584,-88107
2011-08,449069,16574,49822,10549,168572,235100,24690,12470,3244,3797,96.15,1,147.22,465643,501203,-35560
2011-09,496490,43699,34218,14407,172666,212430,21969,37539,1679,2622,281.5,1,90.11,540189,493229,46960
2011-10,220588,21280,33853,10401,91149,200435,7150,16298,815,3674,321.34,1,96.75,241868,359286,-117418
2011-11,488869,46005,45138,5552,94796,125122,19708,20734,1158,3454,449.37,0,131.65,534874,311050,223824
2011-12,102685,26530,28696,9059,101049,244197,20626,22723,4690,3831,-78.03,1,140.36,129215,426350,-297135
2012-01,344161,17532,43586,14513,192901,185529,18824,23404,1005,2528,317.36,0,119.95,361693,478757,-117064
2012-02,435238,39636,29467,9629,170772,246705,27263,31242,4344,1289,76.57,0,146.29,474874,515078,-40204
2012-03,468886,23328,29047,11150,88421,68480,7319,24927,2907,3014,172.46,1,99.08,492214,229344,262870
2012-04,182691,24390,49647,7829,139264,210556,8718,24506,3348,576,-27.18,1,140.73,207081,440520,-233439
2012-05,244002,29081,32920,14517,170872,244534,13046,33000,3818,1049,136.86,0,136.45,273083,508889,-235806
2012-06,313208,23222,24940,14536,95229,210122,28183,18873,4888,1041,14.08,0,80.49,336430,391883,-55453
2012-07,149413,23040,37183,6443,101420,112486,10143,36429,3962,2737,58.16,0,111.02,172453,304104,-131651
2012-08,163868,38966,20887,12237,144957,180913,10308,28321,564,2790,387.57,1,129.37,202834,397623,-194789
2012-09,350891,48696,30961,12037,84975,139183,29244,11436,4759,3162,37.92,1,102.18,399587,307836,91751
2012-10,135468,41114,44227,8671,167482,104045,13329,12913,1884,1425,108.12,1,143.79,176582,350667,-174085
2012-11,236926,35410,36263,6180,128080,121381,19653,6318,2502,357,179.51,0,83.74,272336,317875,-45539
2012-12,434935,40484,43452,7006,179436,96505,29577,19684,1620,553,305.99,1,99.1,475419,375660,99759
2013-01,237735,10239,32294,10009,154002,115830,28508,10945,4374,2103,80.26,0,87.1,247974,351588,-103614
2013-02,159268,10301,33433,11654,165710,176510,13223,25420,2720,1316,-6.63,0,125.83,169569,425950,-256381
2013-03,193219,33323,48937,5967,179126,120731,13437,20132,1359,2432,73.05,1,125.57,226542,388330,-161788
2013-04,363212,27662,23005,7759,164634,121366,22251,7532,2848,3354,121.86,1,96.16,390874,346547,44327
2013-05,210773,28628,37633,8375,190883,243071,19744,21827,1072,1650,260.35,0,123.89,239401,521533,-282132
2013-06,298125,25522,48919,11470,81707,70663,16580,33658,907,914,368.93,0,87.51,323647,262997,60650
2013-07,145045,46177,34738,9701,97053,171714,24738,15276,4020,1625,30.59,0,146.85,191222,353220,-161998
2013-08,205037,18351,38222,6148,174075,73077,19843,39287,2407,2536,96.95,1,98.58,223388,350652,-127264
2013-09,151195,32594,45785,10270,100142,230433,10049,30905,1071,1498,74.66,1,116.72,183789,427584,-243795
2013-10,232681,48125,48975,7758,106947,101068,6299,31798,751,2736,301.82,1,91.8,280806,302845,-22039
2013-11,364765,11306,42429,11807,186115,196141,10353,22639,928,3899,403.51,0,89.36,376071,469484,-93413
2013-12,113497,36417,23298,8601,157487,98360,15828,31200,2674,3101,88.45,1,149.06,149914,334774,-184860
2014-01,230918,42681,42313,12161,166493,58688,16516,17444,4925,1614,100.07,0,119.52,273599,313615,-40016
2014-02,452612,12953,44269,5792,182050,249940,10008,10864,2056,1223,301.97,0,113.11,465565,502923,-37358
2014-03,131156,48092,43494,14925,131313,99867,26149,21527,3814,1187,10.46,1,83.18,179248,337275,-158027
2014-04,211556,16398,30012,11532,145010,119195,25817,7313,4216,3865,61.8,1,114.33,227954,338879,-110925
2014-05,173224,34471,31127,11894,186944,99989,13910,29269,3157,2860,-11.97,0,95.85,207695,373133,-165438
2014-06,127389,15751,46334,11880,105371,240517,24363,30434,1917,2224,50.47,0,88.02,143140,458899,-315759
2014-07,275552,24862,35860,6946,114600,53550,17219,26221,2119,3578,111.25,0,136.07,300414,254396,46018
2014-08,339416,40802,40493,14136,150745,85601,18846,7022,2682,1845,134.27,1,147.56,380218,316843,63375
2014-09,356197,24156,45874,10382,88943,55050,29241,6055,4042,1829,12.88,1,99.76,380353,235545,144808
2014-10,169946,29981,22530,10674,80829,240444,22991,12506,2784,1781,10.44,1,112.23,199927,389974,-190047
2014-11,131848,42946,36492,14715,150662,179655,14802,19478,3895,2347,21.45,0,149.23,174794,415804,-241010
2014-12,487019,38012,44517,6231,89497,101432,20024,36178,4621,1236,112.64,1,134.98,525031,297879,227152
2015-01,136026,10129,45016,8414,190278,109883,7305,16717,1083,2191,206.45,0,112.05,146155,377613,-231458
2015-02,124266,36133,34997,13158,182549,58104,25022,36624,1902,1737,86.35,0,101.29,160399,350454,-190055
2015-03,386334,17135,30356,14438,81949,206686,18250,27136,2375,1413,129.96,1,132.21,403469,378815,24654
2015-04,307672,30502,40577,12593,97443,193987,26627,15778,1456,3287,201.18,1,113.21,338174,387005,-48831
2015-05,220112,19647,41801,6685,193591,84271,29973,31541,3299,1410,108.34,0,114.67,239759,387862,-148103
2015-06,331121,30240,35176,12921,196415,210759,21587,9879,3612,3116,8.86,0,120.5,361361,486737,-125376
2015-07,495380,18601,32658,8702,182645,215052,21917,10810,1333,2942,228.65,0,86.34,513981,471784,42197
2015-08,482673,12821,39372,8201,134037,224362,28083,14406,2471,2665,77.57,1,145.26,495494,448461,47033
2015-09,346906,47820,49948,9933,107626,89210,24511,35947,4124,2135,127.35,1,110.06,394726,317175,77551
2015-10,151836,33557,38208,8119,89092,68349,20654,10646,4596,1858,17.96,1,149.83,185393,235068,-49675
2015-11,232705,44107,38357,12702,87955,243342,24046,19400,1708,2758,142.74,0,80.69,276812,425802,-148990
2015-12,203761,28815,29944,9154,142035,163005,11408,20289,3071,2801,18.5,1,132.81,232576,375835,-143259
2016-01,232877,32540,48928,13868,138335,192465,11771,19638,4087,560,127.64,0,103.39,265417,425005,-159588
2016-02,286374,17471,48945,13399,193513,248233,10606,9735,1067,1706,346.02,0,114.01,303845,524431,-220586
2016-03,191987,22902,40274,5685,157326,243351,23465,7010,2540,482,100.82,1,103.03,214889,477111,-262222
2016-04,122770,30432,36273,12964,125205,146885,15654,31592,1705,1497,53.33,1,95.73,153202,368573,-215371
2016-05,317152,11556,38208,12176,93040,112078,17696,31449,4931,1783,106.61,0,120.21,328708,304647,24061
2016-06,404838,46715,32592,8410,106367,126956,26876,37871,4463,2625,125.48,0,120.26,451553,339072,112481
2016-07,423904,38356,27380,10802,110403,222600,16302,35923,2487,2312,170.69,0,83.87,462260,423410,38850
2016-08,188393,48423,48353,10591,122883,123553,8799,36141,4593,1763,4.13,1,137.65,236816,350320,-113504
2016-09,324884,29834,49486,6442,159594,81984,22090,32312,1991,1366,143.2,1,102.7,354718,351908,2810
2016-10,297857,35796,35715,9633,119209,237716,27648,34904,2307,1521,64.41,1,109.65,333653,464825,-131172
2016-11,152427,35595,42416,10045,184540,210561,7396,29886,2040,819,175.41,0,120.67,188022,484844,-296822
2016-12,421583,40049,24311,5839,134433,237983,10828,36724,4430,3662,122.72,1,96.21,461632,450118,11514
2017-01,451909,46129,44308,14310,158289,63564,24435,25143,788,1652,573.9,0,128.44,498038,330049,167989
2017-02,489607,45109,47985,7616,195171,55280,24258,25372,3750,3380,224.06,0,122.43,534716,355682,179034
2017-03,170484,38175,39723,6619,108610,230758,21948,7800,1707,3495,18.34,1,99.29,208659,415458,-206799
2017-04,165348,43590,48677,9458,118186,108282,19803,23556,3968,3666,95.0,1,122.78,208938,327962,-119024
2017-05,243054,32650,41600,10933,190870,105894,9330,38792,4583,1602,8.81,0,85.89,275704,397419,-121715
2017-06,291544,41427,22004,10064,146539,69598,12072,16883,3598,1524,63.83,0,122.41,332971,277160,55811
2017-07,272139,24081,30733,5896,111727,64436,28390,13705,1697,3809,128.67,0,89.79,296220,254887,41333
2017-08,485718,18059,25395,10213,103349,99905,24253,26245,3581,1232,126.98,1,106.19,503777,289360,214417
2017-09,395291,30615,20437,12505,180938,131008,20446,27864,3998,2823,153.92,1,112.38,425906,393198,32708
2017-10,239145,26614,43733,6754,121975,106646,29832,32747,4896,2792,25.65,1,106.42,265759,341687,-75928
2017-11,161341,28040,36579,13229,107498,74033,16313,16153,1046,3132,145.88,0,80.39,189381,263805,-74424
2017-12,261056,14934,32080,11490,192949,53952,5824,30108,4926,2483,34.4,1,98.63,275990,326403,-50413
2018-01,264271,29424,35842,12888,80462,98381,25368,25787,4916,3853,186.43,0,136.9,293695,278728,14967
2018-02,484900,35035,44179,12517,106289,240699,23952,14538,1995,3549,240.2,0,139.38,519935,442174,77761
2018-03,299954,17818,28061,11065,177400,243371,21123,21523,1387,1241,266.73,1,126.75,317772,502543,-184771
2018-04,342904,49123,36964,13820,118220,139690,24079,12010,4443,2465,142.6,1,101.75,392027,344783,47244
2018-05,481582,23924,39204,13977,108997,173599,8988,24943,2020,965,240.27,0,148.11,505506,369708,135798
2018-06,390659,10023,22386,6591,123627,80225,16866,26940,3819,2093,123.65,0,89.22,400682,276635,124047
2018-07,178614,10182,27898,13165,134967,182428,10316,17477,3079,2519,34.84,0,136.82,188796,386251,-197455
2018-08,361000,19634,27304,12167,161440,162412,5699,34197,664,1046,477.34,1,115.99,380634,403219,-22585
2018-09,456374,18847,40253,6708,181167,246342,18464,9309,4210,3020,120.37,1,98.51,475221,502243,-27022
2018-10,470773,49090,41006,13463,197054,190913,28495,17859,2604,2273,181.71,1,95.71,519863,488790,31073
2018-11,176736,19757,37097,12349,191563,219918,11362,26351,4492,2558,3.51,0,107.69,196493,498640,-302147
2018-12,350987,27328,20846,10938,162109,246217,6196,6375,1754,1173,226.76,1,131.07,378315,452681,-74366
2019-01,203384,12343,31366,7124,83425,80479,15593,23355,793,1585,192.61,0,145.36,215727,241342,-25615
2019-02,376492,33317,21644,8534,107968,199997,8531,6344,3611,426,96.64,0,134.3,409809,353018,56791
2019-03,380431,47340,30648,7941,132805,51691,7549,5910,1030,2116,339.6,1,127.66,427771,236544,191227
2019-04,363149,26316,37267,6770,132942,93017,21353,34355,1008,3877,397.04,1,111.32,389465,325704,63761
2019-05,382435,22313,40968,7933,153696,93099,29694,25624,3592,1820,96.64,0,140.27,404748,351014,53734
2019-06,399818,18295,48993,8936,191375,86682,24214,13955,2009,3178,205.17,0,145.01,418113,374155,43958
2019-07,116980,29813,41515,14573,195342,133118,14878,39076,4650,3117,15.18,0,115.85,146793,438502,-291709
2019-08,250811,10025,29799,8831,117343,106680,11224,9297,1955,3450,4.85,1,147.05,260836,283174,-22338
2019-09,424179,26238,44418,8541,117894,159824,17073,37145,4390,2107,127.66,1,107.67,450417,384895,65522
2019-10,253924,19598,41644,8907,154428,84602,7257,27858,1259,3251,207.64,1,89.73,273522,324696,-51174
2019-11,234593,11606,45902,12847,129867,158628,24339,13935,821,2402,314.52,0,101.22,246199,385518,-139319
2019-12,344489,35696,41113,9751,145613,162052,19454,28805,4200,3683,90.89,1,108.64,380185,406788,-26603
2020-01,437518,24220,27585,9564,97824,132747,9377,12904,4253,667,58.14,0,107.61,461738,290001,171737
2020-02,119658,16533,47737,11234,169023,88282,26961,32514,1946,716,39.02,0,133.02,136191,375751,-239560
2020-03,337679,14978,23936,14863,82389,126358,9656,5028,1791,2118,201.38,1,104.05,352657,262230,90427
2020-04,451601,11258,35577,10529,145737,153925,23859,25343,4660,1834,141.42,1,149.35,462859,394970,67889
2020-05,445713,32665,35374,9835,103999,103459,6860,5769,1744,3270,166.64,0,130.42,478378,265296,213082
2020-06,413833,27621,23424,10990,139821,137237,12793,16359,1004,2793,395.72,0,129.37,441454,340624,100830
2020-07,440083,14187,49250,6395,86359,232445,12595,26393,1662,3170,289.06,0,101.15,454270,413437,40833
2020-08,118495,19309,43261,14667,160852,189294,18176,12954,4199,3283,-8.65,1,141.87,137804,439204,-301400
2020-09,179032,18197,21912,6853,104437,148816,24611,9444,1875,2011,109.85,1,143.56,197229,316073,-118844
2020-10,492746,28593,44372,5034,96275,199858,10382,23418,1585,3609,335.33,1,147.79,521339,379339,142000
2020-11,134331,17184,37550,8560,141364,133068,5055,39851,4220,3140,86.21,0,91.62,151515,365448,-213933
2020-12,493783,32204,44720,11970,118423,170538,11389,39729,934,420,461.48,1,138.79,525987,396769,129218
2021-01,404985,16701,21321,13525,127234,220645,16443,32711,1618,3884,400.26,0,135.28,421686,431879,-10193
2021-02,280852,33836,23411,6546,112737,246840,25322,11335,4789,313,-9.45,0,108.85,314688,426191,-111503
2021-03,438501,32201,21998,5218,138088,215606,29727,35383,4501,3896,133.99,1,101.49,470702,446020,24682
2021-04,144953,47107,39530,9562,155950,195065,19826,16480,584,1420,258.1,1,140.53,192060,436413,-244353
2021-05,151301,30345,45399,12967,150467,142058,5261,25660,2394,3042,125.07,0,109.57,181646,381812,-200166
2021-06,358520,48345,45444,6207,150628,108562,9067,25154,670,3221,586.39,0,111.02,406865,345062,61803
2021-07,224357,10065,41281,13458,125885,235883,28907,38666,2490,2942,134.81,0,114.18,234422,484080,-249658
2021-08,213618,24671,25166,10538,171233,134762,20983,16929,3813,513,-18.82,1,115.45,238289,379611,-141322
2021-09,116888,25326,21450,13616,127816,82217,16987,28581,1240,1826,96.98,1,118.03,142214,290667,-148453
2021-10,101116,18172,22898,7862,140788,110809,12621,9099,4789,2711,18.23,1,84.62,119288,304077,-184789
2021-11,293433,43745,31472,8076,85472,139676,5896,26802,2134,1142,118.74,0,117.27,337178,297394,39784
2021-12,120986,29022,43133,13148,180578,86917,11045,28703,1604,3152,6.11,1,98.93,150008,363524,-213516
2022-01,183528,32464,44987,13628,99040,104691,20433,28878,2443,3631,18.36,0,109.99,215992,311657,-95665
2022-02,193030,47323,21507,12084,85402,218545,13225,26845,3074,2928,50.76,0,140.55,240353,377608,-137255
2022-03,424263,25908,41376,6896,114542,119607,21839,22835,1316,1635,239.2,1,106.55,450171,327095,123076
2022-04,386651,28702,22460,12061,140600,92136,22613,24814,4035,1148,126.68,1,116.73,415353,314684,100669
2022-05,195942,26933,38343,9730,176859,88114,7578,26687,4159,1741,90.96,0,139.17,222875,347311,-124436
2022-06,332731,12495,34765,6389,144711,59073,9691,36888,4428,2165,165.62,0,95.75,345226,291517,53709
2022-07,468727,45166,23987,14270,185006,110918,22350,26615,1220,2485,323.27,0,143.23,513893,383146,130747
2022-08,432386,27257,39861,14705,198655,67117,11646,8453,4860,3438,83.09,1,102.39,459643,340437,119206
2022-09,228073,24409,25252,6146,107881,174653,6190,34049,2708,3555,17.17,1,144.13,252482,354171,-101689
2022-10,261635,13224,23023,14108,180381,139961,5229,24879,2441,948,50.28,1,86.57,274859,387581,-112722
2022-11,203120,33494,23910,8883,150877,80113,18734,36889,984,3834,209.14,0,86.24,236614,319406,-82792
2022-12,108380,22024,32224,5284,149774,249753,29676,20253,4295,946,-69.61,1,105.89,130404,486964,-356560
2023-01,350989,28872,20654,5893,194097,92626,18295,35901,1988,2330,189.14,0,94.17,379861,367466,12395
2023-02,420450,25821,48882,13642,111123,144610,19348,17695,4596,1669,77.95,0,122.16,446271,355300,90971
2023-03,319372,19262,47635,9328,146924,171295,22786,34498,3404,2589,35.05,1,83.34,338634,432466,-93832
2023-04,424844,36473,24840,8212,92904,110287,17718,39651,1705,1171,210.29,1,121.14,461317,293612,167705
2023-05,489987,45941,49816,8079,169841,126725,8221,8575,2270,1699,205.78,0,127.61,535928,371257,164671
2023-06,467346,30603,44234,8848,80317,63196,27077,5726,3076,834,122.85,0,98.37,497949,229398,268551
2023-07,149306,34489,21770,8441,107256,243018,24962,21634,4855,1706,104.07,0,96.68,183795,427081,-243286
2023-08,399830,15852,22555,9528,129484,90772,5519,15147,2647,1282,181.46,1,116.22,415682,273005,142677
2023-09,108290,39978,45890,5409,183359,87347,5259,30685,1758,3559,6.35,1,107.33,148268,357949,-209681
2023-10,244173,39195,46295,13002,167341,61210,28122,8238,1866,2006,153.91,1,83.47,283368,324208,-40840
2023-11,321552,20249,44195,9511,133398,240649,7256,35402,3970,3465,39.41,0,98.77,341801,470411,-128610
2023-12,436235,14071,22284,12481,158575,166491,29681,20419,2237,2133,239.95,1,83.38,450306,409931,40375
2024-01,117154,10319,42592,10115,124407,246222,16344,35342,3982,1380,-48.41,0,95.66,127473,475022,-347549
2024-02,453428,20196,37703,7219,157050,195982,19960,30088,3349,1466,72.41,0,134.93,473624,448002,25622
2024-03,372509,29847,28845,10689,156473,101438,11058,19908,2852,497,141.73,1,120.06,402356,328411,73945
2024-04,222022,47946,48553,9393,198071,219761,7267,16346,2306,2641,90.91,1,123.98,269968,499391,-229423
2024-05,377407,30790,25543,11929,127105,96293,8793,25062,2251,2100,97.72,0,105.06,408197,294725,113472
2024-06,200806,14589,38926,9560,175179,110617,28808,32294,3658,1060,115.01,0,144.18,215395,395384,-179989
2024-07,300758,13311,39456,9327,172154,161465,13642,30216,2692,901,221.22,0,84.99,314069,426260,-112191
2024-08,435003,19460,35220,5718,83295,190199,22731,9214,608,3542,676.65,1,130.23,454463,346377,108086
2024-09,107186,43840,26749,5741,127191,144257,29020,36277,2447,2933,22.21,1,87.18,151026,369235,-218209
2024-10,385074,14683,45184,9985,109168,115238,16298,11461,2958,3844,178.03,1,144.48,399757,307334,92423
2024-11,382076,18847,46520,9234,140558,141970,11036,31271,4845,598,93.39,0,118.27,400923,380589,20334
2024-12,436563,33189,20189,13873,83627,193246,5622,10649,4551,3407,38.57,1,96.72,469752,327206,142546
2025-01,197924,37305,41989,12843,181756,126531,14274,28119,1213,1707,217.17,0,88.22,235229,405512,-170283
2025-02,234675,22402,21825,11624,146184,230997,9943,26715,4335,1864,74.73,0,84.62,257077,447288,-190211
2025-03,344224,42774,31350,11272,139349,73610,24203,20587,1474,2172,238.39,1,93.96,386998,300371,86627
2025-04,471634,48280,25008,7636,151330,103918,15501,35597,717,1586,639.53,1,87.1,519914,338990,180924
2025-05,398816,42393,40083,11557,99130,116198,8295,24587,3491,3839,167.02,0,119.24,441209,299850,141359
2025-06,202367,18823,22916,13084,151036,92213,12352,23371,1587,451,131.47,0,111.42,221190,314972,-93782
2025-07,113180,26347,41693,7227,194374,103616,29672,34842,1054,2337,46.78,0,98.49,139527,411424,-271897
2025-08,180653,21074,41624,8320,193438,156607,5601,26220,3156,1897,95.0,1,128.16,201727,431810,-230083
2025-09,167129,41819,44272,7521,137574,132124,13269,19368,3791,2213,47.1,1,137.56,208948,354128,-145180
2025-10,487585,29691,26131,7388,173370,169278,6206,32777,4131,3593,122.59,1,146.82,517276,415150,102126
2025-11,255562,12103,33755,6896,80719,92441,12657,35809,3769,3859,127.78,0,118.49,267665,262277,5388
2025-12,358790,45997,40003,11146,87467,152913,17631,12360,4395,3016,141.25,1,83.86,404787,321520,83267
2026-01,154581,12776,21461,8274,138688,152434,11300,7975,3087,2271,54.31,0,85.11,167357,340132,-172775
2026-02,430801,17795,29860,12445,194531,221532,24893,13960,2997,1127,206.33,0,94.76,448596,497221,-48625
2026-03,181446,43656,20724,11192,120324,121361,11397,29571,4187,2762,85.84,1,94.36,225102,314569,-89467
2026-04,489277,40519,33342,10778,166445,55128,19082,31581,2305,2482,175.1,1,115.9,529796,316356,213440
2026-05,178775,48592,36025,5628,185559,239669,18101,15732,3175,2483,79.58,0,144.55,227367,500714,-273347
2026-06,245217,39090,30914,6683,150522,221122,12827,31554,2872,380,152.01,0,146.3,284307,453622,-169315
2026-07,375484,25369,45312,7895,154019,192475,8698,32842,4877,1674,136.31,0,104.02,400853,441241,-40388
2026-08,432488,49905,30792,5275,165141,215399,19024,36102,1244,1506,375.41,1,89.85,482393,471733,10660
2026-09,408295,12246,49650,10748,90850,237303,10421,12282,4634,747,55.17,1,118.33,420541,411254,9287
2026-10,378350,27310,30421,13207,187865,50320,15282,31328,1372,2642,231.35,1,143.45,405660,328423,77237
2026-11,450396,11758,25322,5657,156211,238333,5016,29930,958,1480,416.24,0,122.84,462154,460469,1685
2026-12,234556,44921,30231,5365,180094,147475,8109,9393,4429,2630,43.94,1,140.92,279477,380667,-101190
2027-01,240886,23617,33955,10336,115289,97212,20957,18026,2927,946,163.7,0,128.1,264503,295775,-31272
2027-02,110431,26184,40925,11150,115381,170047,15919,35208,675,808,240.5,0,122.05,136615,388630,-252015
2027-03,108473,28125,40752,7857,185942,76940,16491,5359,4727,475,-18.98,1,115.93,136598,333341,-196743
2027-04,328914,25570,34155,10290,135747,176978,21095,28251,3833,1949,102.25,1,134.46,354484,406516,-52032
2027-05,226123,11310,35800,5049,145022,57645,17556,20934,1587,952,166.92,0,145.7,237433,282006,-44573
2027-06,395330,39110,27986,10582,184601,206146,22573,16660,2828,2150,236.9,0,102.64,434440,468548,-34108
2027-07,331001,44057,27766,5849,144291,115243,29098,8018,3722,3898,97.84,0,120.54,375058,330265,44793
2027-08,175799,49737,37344,14170,165305,159867,18271,22474,4169,1703,73.25,1,119.4,225536,417431,-191895
2027-09,252646,38943,23477,11879,164886,218141,10779,8337,792,1303,177.45,1,106.49,291589,437499,-145910
2027-10,366599,21904,35649,10636,197651,160034,15943,25186,2509,1696,143.89,1,142.9,388503,445099,-56596
2027-11,467644,45050,39501,10256,89997,151993,28478,19650,3401,730,-10.86,0,147.12,512694,339875,172819
2027-12,318752,46715,39281,11407,184384,158818,11393,14401,4102,2756,84.36,1,94.87,365467,419684,-54217
2028-01,387927,15612,49238,10423,111877,233572,24606,6803,3064,3508,159.14,0,99.34,403539,436519,-32980
2028-02,351416,42845,22098,10957,181718,79721,22977,10330,1988,3941,143.8,0,115.32,394261,327801,66460
2028-03,388412,34562,48437,12858,125064,190957,23892,31416,621,2258,644.2,1,127.75,422974,432624,-9650
2028-04,300407,19408,23890,11284,154937,101042,12786,7793,684,473,425.27,1,109.81,319815,311732,8083
2028-05,482680,31479,30507,9221,189054,80433,23583,32730,4582,2685,139.86,0,81.62,514159,365528,148631
2028-06,159267,21137,45466,5560,85029,160733,7471,6634,3901,1550,89.07,0,133.23,180404,310893,-130489
2028-07,282576,38053,45160,10344,187652,241967,11759,21166,3875,1386,47.86,0,94.63,320629,518048,-197419
2028-08,173561,23323,45552,6085,192050,113161,20714,32373,1817,3741,115.33,1,124.88,196884,409935,-213051
2028-09,251588,47744,30593,13153,128677,133559,21948,36632,4192,1565,102.19,1,97.77,299332,364562,-65230
2028-10,454184,39162,40039,8463,111597,76895,11499,17747,3816,3752,165.66,1,91.27,493346,266240,227106
2028-11,108637,13210,24627,7115,179246,123456,10851,37635,2298,3320,-23.36,0,113.69,121847,382930,-261083
2028-12,433296,29964,48094,9168,186591,217509,15485,25481,3594,3547,144.88,1,124.56,463260,502328,-39068
2029-01,370204,37621,44775,10526,117194,65707,7511,24291,512,2865,677.27,0,107.09,407825,270004,137821
2029-02,258750,37740,41452,6297,149231,60717,28127,6951,2889,1891,81.77,0,100.6,296490,292775,3715
2029-03,314299,35702,21823,11953,152748,179028,17430,17677,4725,1537,14.29,1,142.74,350001,400659,-50658
2029-04,193510,43657,35031,8031,165400,249802,15836,8229,581,3219,225.22,1,114.4,237167,482329,-245162
2029-05,251937,14704,21437,11225,99158,69746,14530,7182,4768,3639,9.05,0,129.38,266641,223278,43363
2029-06,327131,26103,21297,10559,113128,122887,14287,26752,1967,3839,136.12,0,111.28,353234,308910,44324
2029-07,237478,32940,33216,11047,183299,60391,22517,12154,4200,1940,106.95,0,105.48,270418,322624,-52206
2029-08,443272,42900,47141,7063,92707,247163,5921,21415,3389,2920,107.38,1,97.79,486172,421410,64762
2029-09,282957,36599,28529,13139,198293,118396,5366,14862,3856,456,44.15,1,114.86,319556,378585,-59029
2029-10,438614,37140,20400,10338,174223,156114,28139,37930,694,713,713.02,1,101.9,475754,427144,48610
2029-11,313781,48520,23506,12585,122214,96491,18576,15049,1150,694,288.94,0,88.5,362301,288421,73880
2029-12,481700,30828,45184,9458,170169,83296,27574,29924,4093,3342,122.23,1,94.8,512528,365605,146923
2030-01,163649,33535,29762,7501,147987,75825,8593,11860,1757,2432,46.51,0,109.04,197184,281528,-84344
2030-02,127726,42994,23859,5086,133573,143727,25863,19459,4182,2051,89.37,0,82.87,170720,351567,-180847
2030-03,343639,29053,34674,8788,94181,69602,7042,24896,4844,1947,96.65,1,128.07,372692,239183,133509
2030-04,158448,26670,49838,9665,170983,228732,29562,21903,2337,533,85.37,1,91.78,185118,510683,-325565
2030-05,479421,49274,37818,6112,116012,54466,5576,34050,3064,889,196.35,0,105.67,528695,254034,274661
2030-06,459656,23815,39551,8240,123581,245400,12975,15258,4823,3041,21.13,0,114.73,483471,445005,38466
2030-07,492175,16353,34059,10727,157008,180088,26264,27498,1680,2626,241.87,0,87.93,508528,435644,72884
2030-08,482045,33816,32657,8032,107783,214611,26269,22013,4454,605,90.06,1,140.36,515861,411365,104496
2030-09,331358,20881,27497,10480,156269,132695,18576,13312,4063,974,156.89,1,115.19,352239,358829,-6590
2030-10,395199,16768,47618,5225,183101,63408,11584,13038,1804,1424,121.88,1,113.94,411967,323974,87993
2030-11,280551,33755,49081,9623,86077,181973,7561,29195,4542,1501,80.94,0,95.69,314306,363510,-49204
2030-12,202408,18027,48448,14864,157890,87097,11296,8025,4596,2463,30.11,1,119.21,220435,327620,-107185
2031-01,212890,23075,40746,13893,127504,97492,6339,20531,1925,3210,100.99,0,103.93,235965,306505,-70540
2031-02,116572,27031,29509,14635,106215,233108,20440,17156,3038,1389,84.41,0,131.37,143603,421063,-277460
2031-03,223635,37263,29098,13308,181731,80159,21068,27223,3197,2785,69.57,1,92.24,260898,352587,-91689
2031-04,210499,41518,35946,9380,136742,112904,24905,8903,2317,951,143.54,1,144.7,252017,328780,-76763
2031-05,305986,28548,24665,7538,105924,141596,19818,27547,2155,2187,139.99,0,124.0,334534,327088,7446
2031-06,424255,11184,45193,8634,155154,142491,13438,5249,4967,3870,17.44,0,149.51,435439,370159,65280
2031-07,401190,38772,47964,10549,152506,242313,20620,31449,1702,421,219.8,0,110.02,439962,505401,-65439
2031-08,270728,33983,30812,13683,99233,213425,18263,31579,1728,3212,102.17,1,109.3,304711,406995,-102284
2031-09,141288,46277,31414,8669,182137,151735,27863,5712,1050,1330,191.96,1,115.18,187565,407530,-219965
2031-10,109747,16474,47486,5371,167865,159425,10076,38764,2440,1072,62.75,1,111.37,126221,428987,-302766
2031-11,413508,49232,39007,12535,100652,121490,21959,34700,2414,3142,125.22,0,132.63,462740,330343,132397
2031-12,468898,16802,42488,8752,166471,242382,28907,22497,2971,688,171.81,1,136.93,485700,511497,-25797
2032-01,275585,29079,24882,9326,185455,227590,13141,16649,3824,3506,131.67,0,149.04,304664,477043,-172379
2032-02,141148,26457,46673,6549,102705,216934,16446,39722,4268,3926,92.29,0,116.39,167605,429029,-261424
2032-03,463489,29383,23148,12446,116971,234331,23295,17223,2016,1318,244.53,1,95.53,492872,427414,65458
2032-04,208987,37229,34566,6363,168486,235312,27749,7251,1750,1457,144.05,1,117.45,246216,479727,-233511
2032-05,199768,39965,24454,5247,190105,171479,19619,33937,2102,2166,12.59,0,92.09,239733,444841,-205108
2032-06,188647,13242,34037,13128,128981,179595,14662,37315,1223,3971,215.83,0,99.0,201889,407718,-205829
2032-07,204648,18876,20149,13952,182386,216723,15049,39135,3792,3373,116.24,0,145.17,223524,487394,-263870
2032-08,330946,16175,45238,5788,154218,196315,28508,27629,3966,776,114.83,1,131.53,347121,457696,-110575
2032-09,111478,22916,32467,12457,185217,239691,25958,6241,1130,2488,1.22,1,98.99,134394,502031,-367637
2032-10,201491,16744,38229,10868,104736,59471,15151,6398,2513,3742,83.86,1,149.25,218235,234853,-16618
2032-11,168908,15010,29969,11220,96079,128436,27654,17314,1094,2958,261.01,0,139.42,183918,310672,-126754
2032-12,137699,17226,23184,9732,100953,81431,10342,19455,2312,2981,26.42,1,111.42,154925,245097,-90172
2033-01,444277,17277,49445,8008,144015,77539,27760,25395,4403,2763,207.94,0,148.57,461554,332162,129392
2033-02,249327,33315,35267,7252,104844,183218,26177,39244,3223,3747,66.29,0,129.96,282642,396002,-113360
2033-03,352228,46785,28941,13027,152798,211450,29378,17353,2288,1821,200.45,1,122.37,399013,452947,-53934
2033-04,153099,45258,48357,10903,189225,200366,27000,35351,1220,1776,191.22,1,121.09,198357,511202,-312845
2033-05,307879,14039,20430,13536,174229,71328,23926,19856,702,1063,400.64,0,89.87,321918,323305,-1387
2033-06,444290,26629,27403,8070,171456,66468,22359,36412,540,1690,755.07,0,84.82,470919,332168,138751
2033-07,144271,42586,26586,14216,159311,154970,11627,27864,4488,1886,-25.55,0,144.86,186857,394574,-207717
2033-08,410224,16606,37137,8157,181588,191783,16560,31671,1052,1656,415.45,1,149.94,426830,466896,-40066
2033-09,280243,29457,25858,14085,160986,113303,6733,8372,1660,1189,117.48,1,137.89,309700,329337,-19637
2033-10,363219,23310,32475,13313,140262,152181,18804,20147,2374,2062,179.68,1,119.74,386529,377182,9347
2033-11,370135,35490,37484,7430,155903,200833,29658,29450,623,1971,635.11,0,99.1,405625,460758,-55133
2033-12,409519,11240,29766,7851,93423,89589,17866,11518,1367,3592,240.67,1,103.1,420759,250013,170746
2034-01,226811,43271,30582,14632,89066,246730,14504,26885,4326,3247,191.87,0,141.95,270082,422399,-152317
2034-02,473906,48112,45287,10036,125513,86317,20862,19955,1886,971,124.19,0,82.8,522018,307970,214048
2034-03,487661,32906,28447,8714,99075,205855,8871,26150,2174,1411,265.46,1,125.9,520567,377112,143455
2034-04,255471,27353,23563,10566,122602,200156,10276,33929,4390,585,47.29,1,120.3,282824,401092,-118268
2034-05,465152,39471,27249,13236,181730,157627,6673,9925,4061,2989,169.8,0,95.07,504623,396440,108183
2034-06,312701,25082,41158,8178,123562,53958,16447,38426,1294,1629,207.79,0,112.52,337783,281729,56054
2034-07,490572,24835,22200,12472,169637,98709,14277,36672,4427,1079,32.09,0,105.19,515407,353967,161440
2034-08,461790,10269,42075,7851,181390,126743,18334,15941,789,3391,541.7,1,141.35,472059,392334,79725
2034-09,367547,47808,24870,8586,181324,126312,11641,38860,3433,568,136.83,1,120.93,415355,391593,23762
2034-10,159901,17349,46366,14573,188178,196769,25004,9063,4716,1156,83.19,1,137.49,177250,479953,-302703
2034-11,475954,32437,44027,9386,149537,88101,19652,24372,3407,1158,195.62,0,119.4,508391,335075,173316
2034-12,477123,11803,35235,5748,147826,72565,16232,24987,535,2312,803.65,1,101.05,488926,302593,186333
2035-01,232094,28279,31082,10774,195021,139040,26418,14024,3632,3656,129.47,0,140.34,260373,416359,-155986
2035-02,325344,22043,27873,14406,197286,137306,17259,25187,1317,2729,165.99,0,91.2,347387,419317,-71930
2035-03,471941,18571,44453,14996,180546,165731,23798,36284,3197,3535,121.87,1,99.48,490512,465808,24704
2035-04,231774,12957,32360,13185,159865,135963,24663,39457,4715,468,44.53,1,144.24,244731,405493,-160762
2035-05,311546,41475,46633,9133,135827,110300,29553,6936,633,3067,505.47,0,112.77,353021,338382,14639
2035-06,384578,25235,24702,12781,192513,235608,11267,13377,2509,3188,156.78,0,124.22,409813,490248,-80435
2035-07,326566,25858,41430,14432,89939,143411,21743,32215,2644,3023,183.94,0,108.89,352424,343170,9254
2035-08,170839,15705,46604,11265,177284,167801,18349,11758,1246,3101,174.16,1,127.82,186544,433061,-246517
2035-09,375400,29648,33824,11789,185119,221558,29293,17825,4079,1876,131.37,1,90.02,405048,499408,-94360
2035-10,259456,38204,21742,10107,180328,124661,14704,22427,1403,1544,157.61,1,140.82,297660,373969,-76309
2035-11,402769,24442,23146,11712,138936,195584,7309,12136,3052,1056,65.51,0,144.19,427211,388823,38388
2035-12,309379,22884,38016,7029,93124,172934,13379,15900,4263,3154,99.95,1,124.23,332263,340382,-8119
2036-01,318170,21762,22488,10660,187394,224560,9941,36679,1097,2911,298.12,0,113.51,339932,491722,-151790
2036-02,316393,31980,22427,12271,192853,102867,12301,34900,2532,2461,147.37,0,146.05,348373,377619,-29246
2036-03,422052,18759,31593,5932,101361,177924,12618,5232,3160,1841,79.95,1,122.32,440811,334660,106151
2036-04,238747,48335,28094,5966,181383,55957,16661,8833,4240,3097,54.76,1,88.1,287082,296894,-9812
2036-05,434314,11792,29417,11121,173236,52178,29420,27985,3826,532,162.61,0,80.89,446106,323357,122749
2036-06,122056,27083,35248,7659,130130,50853,19601,8891,4949,3943,-3.33,0,116.53,149139,252382,-103243
2036-07,498050,15882,37846,10990,110457,227647,13056,18754,4833,3258,124.5,0,116.92,513932,418750,95182
2036-08,197592,15635,43900,12085,168553,236899,23041,35043,2328,3051,96.53,1,147.77,213227,519521,-306294
2036-09,374218,28606,29355,11640,124576,222294,22473,8569,1690,2178,130.47,1,110.73,402824,418907,-16083
2036-10,187030,15175,39167,10212,93226,226918,24641,22997,1940,639,67.77,1,124.05,202205,417161,-214956
2036-11,428670,44640,20067,5524,136203,98873,17767,34500,4034,2276,188.19,0,105.12,473310,312934,160376
2036-12,125855,23811,48485,12602,124976,52003,20445,23088,2177,2088,37.04,1,148.8,149666,281599,-131933
2037-01,232753,23635,48514,13935,170135,101823,13219,29995,1713,2220,197.27,0,94.7,256388,377621,-121233
2037-02,311199,40637,23224,7809,193035,164557,18572,36117,1481,2229,275.23,0,102.78,351836,443314,-91478
2037-03,338313,21631,39317,10092,141657,103260,14823,22741,2766,3293,62.91,1,111.41,359944,331890,28054
2037-04,498267,16985,41418,10346,160747,96546,13590,38503,1199,1060,311.98,1,104.7,515252,361150,154102
2037-05,343215,30840,49702,10763,131615,88797,15760,20923,503,2214,714.29,0,86.45,374055,317560,56495
2037-06,132354,23422,26077,7033,109751,205338,17338,35844,4654,1900,81.81,0,97.02,155776,401381,-245605
2037-07,304988,42670,28813,9987,141252,73311,14247,28640,2883,2317,146.33,0,83.07,347658,296250,51408
2037-08,363589,26690,32258,14444,169424,176232,17428,36094,1010,3199,407.93,1,146.39,390279,445880,-55601
2037-09,497903,38798,32739,8125,106926,217422,5574,24917,4706,857,122.46,1,117.12,536701,395703,140998
2037-10,261728,40064,35873,8981,100743,137048,11609,18905,4040,2803,71.56,1,114.82,301792,313159,-11367
2037-11,140304,22718,47180,8498,195197,115993,14610,8453,4464,2020,-91.22,0,112.96,163022,389931,-226909
2037-12,242522,49856,22081,14791,96687,117363,29578,26394,4116,3094,48.61,1,138.64,292378,306894,-14516
2038-01,438993,49932,22676,8722,169583,62634,27089,10341,863,511,571.93,0,127.7,488925,301045,187880
2038-02,485717,30293,24396,10504,149765,161172,10915,12657,540,1574,968.79,0,137.91,516010,369409,146601
2038-03,329487,33649,25108,14937,189884,99297,29169,16220,1318,1399,198.1,1,118.07,363136,374615,-11479
2038-04,289137,28049,25024,8331,99002,63117,25512,32080,2758,2090,90.28,1,142.59,317186,253066,64120
2038-05,407044,32669,40680,8887,177805,62247,16199,15775,1624,989,324.33,0,82.83,439713,321593,118120
2038-06,110001,29248,25963,5271,136038,123554,18099,16914,3679,3485,-53.12,0,98.09,139249,325839,-186590
2038-07,344430,44894,29321,5328,196018,95915,27330,39696,4353,3219,42.01,0,92.75,389324,393608,-4284
2038-08,232947,10604,34057,14731,120160,141502,8257,25574,1289,886,108.25,1,131.8,243551,344281,-100730
2038-09,468631,40894,42712,5636,143255,73556,16902,33427,2405,1696,184.8,1,149.71,509525,315488,194037
2038-10,397817,14130,48049,11346,102481,177310,29456,33585,2628,1870,107.09,1,102.49,411947,402227,9720
2038-11,110206,40154,48151,9474,117676,99249,14786,31129,3994,2819,-41.55,0,145.58,150360,320465,-170105
2038-12,266627,39708,42965,5870,195018,68506,16695,22811,4833,1277,75.61,1,145.97,306335,351865,-45530
2039-01,476640,37276,39866,7584,105863,122626,16045,24013,775,710,674.9,0,123.16,513916,315997,197919
2039-02,493545,38954,49700,8974,87919,185867,24915,34248,4436,1435,68.66,0,124.47,532499,391623,140876
2039-03,450601,41292,33710,13647,128578,223949,28253,11875,2190,1280,144.75,1,108.69,491893,440012,51881
2039-04,436922,21520,31976,7364,133946,85165,16956,24221,593,2318,822.78,1,86.59,458442,299628,158814
2039-05,116467,23792,42983,6532,164706,85051,28166,27307,759,2398,128.78,0,94.11,140259,354745,-214486
2039-06,200477,35620,33385,13336,190532,136331,29090,29126,2992,2872,82.99,0,101.27,236097,431800,-195703
2039-07,313513,42196,27791,5957,136279,139240,5670,35598,2494,2061,77.24,0,107.82,355709,350535,5174
2039-08,123550,46917,33348,11070,80495,59018,24052,35737,1186,1390,111.28,1,143.18,170467,243720,-73253
2039-09,395296,19930,31452,7392,87692,163111,12727,8496,1061,3469,401.52,1,80.29,415226,310870,104356
2039-10,364888,15077,36305,8333,198546,213943,15989,22495,4129,693,148.23,1,129.01,379965,495611,-115646
2039-11,402709,28841,27410,11958,161435,158102,23883,17308,942,3602,478.23,0,149.22,431550,400096,31454
2039-12,143231,10678,48663,13480,195043,171826,9640,16649,3329,3371,-15.47,1,143.02,153909,455301,-301392
2040-01,333348,27531,45169,10525,132604,242127,15578,9637,4217,1652,147.82,0,131.36,360879,455640,-94761
2040-02,169635,28785,20313,12135,199906,224800,28082,18188,1290,2703,221.88,0,120.38,198420,503424,-305004
2040-03,327118,32141,30980,13052,127299,78009,29215,32155,2597,826,120.25,1,145.67,359259,310710,48549
2040-04,408942,44923,49781,10984,120745,219574,24883,38661,2749,3995,160.35,1,104.04,453865,464628,-10763
2040-05,479998,31487,31665,7234,86771,245980,5717,23543,929,1643,514.79,0,110.43,511485,400910,110575
2040-06,249203,14303,21388,9895,129120,248498,11656,25389,4394,796,-17.06,0,137.6,263506,445946,-182440
2040-07,227396,11675,26266,13716,178866,85406,24914,7843,4293,3067,67.02,0,81.39,239071,337011,-97940
2040-08,225139,42501,33281,8410,132922,222041,22085,30518,4639,1806,32.76,1,115.84,267640,449257,-181617
2040-09,318652,21091,22509,8350,184003,91571,28485,11679,1827,3021,265.12,1,133.49,339743,346597,-6854
2040-10,283345,42872,30018,14573,122679,58113,29802,5752,4106,961,107.25,1,125.28,326217,260937,65280
2040-11,462217,28244,27729,10805,117327,110159,14096,17512,2459,2770,157.43,0,140.46,490461,297628,192833
2040-12,316151,47702,20816,8890,115674,166463,9036,36139,3853,3702,121.11,1,103.82,363853,357018,6835
2041-01,188881,46370,31843,6100,94658,198697,19165,18381,1042,3032,270.08,0,126.56,235251,368844,-133593
2041-02,343082,34505,25928,10583,103386,158462,29189,13496,2757,575,-26.99,0,135.42,377587,341044,36543
2041-03,231302,33454,44920,11763,82248,153387,18099,20987,4811,3320,18.17,1,99.13,264756,331404,-66648
2041-04,405803,49211,20466,12531,166833,182614,26623,23460,1280,356,363.77,1,118.84,455014,432527,22487
2041-05,462394,36648,24193,12729,116076,67132,21215,30959,1438,2305,269.15,0,101.43,499042,272304,226738
2041-06,159464,11537,49408,11269,118613,95804,10727,36169,2823,1664,15.86,0,98.71,171001,321990,-150989
2041-07,175424,43460,29499,6093,145675,197648,9683,36224,1861,3738,73.5,0,92.11,218884,424822,-205938
2041-08,386692,43761,27250,6572,86459,224061,14306,22736,2319,2114,209.34,1,87.77,430453,381384,49069
2041-09,405259,15767,26680,9764,96414,197016,11742,23702,2022,3139,254.3,1,103.55,421026,365318,55708
2041-10,256313,10248,20093,8362,130006,169305,26824,39772,1924,2741,162.37,1,85.81,266561,394362,-127801
2041-11,462077,25506,45059,5826,170445,97049,28168,11426,2942,683,268.69,0,107.86,487583,357973,129610
2041-12,349448,35908,43559,11978,119592,102446,28611,32149,3025,2642,40.55,1,139.25,385356,338335,47021
2042-01,332671,38313,31334,11283,113033,166467,7336,21834,1373,3832,241.71,0,116.93,370984,351287,19697
2042-02,370020,30548,41968,11406,194020,108597,12926,8694,3190,2953,76.95,0,99.16,400568,377611,22957
2042-03,246118,12236,21486,7189,157797,170836,8401,29875,1390,3540,117.49,1,126.33,258354,395584,-137230
2042-04,224835,29899,38882,7202,120530,150188,7318,26664,1903,1667,54.63,1,119.6,254734,350784,-96050
2042-05,157492,24936,21161,13104,169724,158272,9352,24572,4417,3699,37.89,0,100.6,182428,396185,-213757
2042-06,300473,32556,36635,11988,168784,61920,17160,28575,2765,2635,85.28,0,125.57,333029,325062,7967
2042-07,350716,14870,41297,7560,151375,77814,16316,26930,4064,2026,120.04,0,138.99,365586,321292,44294
2042-08,282937,41739,20029,12895,151847,85122,12424,34462,530,3160,551.75,1,122.06,324676,316779,7897
2042-09,186882,38417,45040,13186,123567,82700,27590,30721,2369,1589,48.56,1,107.99,225299,322804,-97505
2042-10,355440,29145,24613,7162,126648,109742,27118,19182,3465,632,110.29,1,111.05,384585,314465,70120
2042-11,395483,29200,23775,7459,122995,224682,23204,5356,1881,3641,187.47,0,82.64,424683,407471,17212
2042-12,222325,27360,45735,11811,191716,101010,5292,6861,2967,3686,41.69,1,90.88,249685,362425,-112740
2043-01,107910,38205,25674,12945,191334,242834,27889,30650,4765,545,116.3,0,109.57,146115,531326,-385211
2043-02,365310,46000,41288,10226,133477,55974,5426,33921,1671,1545,293.14,0,95.99,411310,280312,130998
2043-03,329089,32123,45811,11468,159156,237505,25466,22099,1148,695,229.67,1,104.61,361212,501505,-140293
2043-04,481832,18060,38467,11800,159300,111349,18913,8873,2978,3689,183.25,1,144.59,499892,348702,151190
2043-05,454055,16320,20984,12821,183097,94985,11983,20955,4050,757,43.69,0,112.03,470375,344825,125550
2043-06,246662,26251,41914,11850,153929,247382,14340,21089,4211,3717,93.94,0,85.71,272913,490504,-217591
2043-07,436423,16806,30649,7786,114263,75866,29323,15012,2024,3718,240.09,0,98.82,453229,272899,180330
2043-08,381408,37471,44907,9158,121976,62820,21040,29946,2380,343,143.88,1,91.87,418879,289847,129032
2043-09,356260,13323,23171,5234,185276,53933,20908,38387,4558,1146,-8.52,1,105.91,369583,326909,42674
2043-10,174425,17446,35462,13792,163063,235997,10039,17577,4134,2904,28.39,1,147.35,191871,475930,-284059
2043-11,248450,45733,48427,11997,166170,191428,8732,39943,1404,538,76.76,0,112.25,294183,466697,-172514
2043-12,176020,15164,22293,13108,109069,121745,9662,16181,2890,2853,47.83,1,104.71,191184,292058,-100874
2044-01,111763,27448,22354,5445,126806,64393,7783,29084,4012,3613,34.44,0,98.98,139211,255865,-116654
2044-02,160478,45716,41079,7263,192779,147243,10770,18264,2058,1166,54.12,0,117.83,206194,417398,-211204
2044-03,255845,11457,27530,12457,99131,146796,22793,26374,1176,2552,173.3,1,132.07,267302,335081,-67779
2044-04,374147,10038,41462,6844,134146,116706,21420,14430,599,551,574.59,1,114.25,384185,335008,49177
2044-05,324979,34303,27252,6026,152939,141667,13036,8175,1982,2362,155.45,0,106.43,359282,349095,10187
2044-06,148687,47128,41881,13227,82551,97924,25826,30366,902,3804,206.68,0,113.92,195815,291775,-95960
2044-07,233989,29753,37618,7407,164832,244069,11789,35083,3984,1228,53.17,0,134.46,263742,500798,-237056
2044-08,378169,10540,34532,12988,190855,131317,5278,23467,1782,2597,181.44,1,113.69,388709,398437,-9728
2044-09,135376,38117,34742,14344,114542,196393,6830,30030,1469,865,192.33,1,144.86,173493,396881,-223388
2044-10,380030,37470,36078,8645,84982,140306,11030,16033,4598,825,88.01,1,111.85,417500,297074,120426
2044-11,253685,47449,31449,14158,184966,153061,26169,36818,2995,2453,152.01,0,109.77,301134,446621,-145487
2044-12,145854,37546,38160,14284,83172,244515,5423,22467,3015,1016,16.24,1,99.84,183400,408021,-224621
2045-01,415218,24536,40176,6517,133287,216216,29232,16176,1031,3776,456.39,0,134.57,439754,441604,-1850
2045-02,417170,28825,30766,12733,95663,219434,24690,32971,3491,3462,86.59,0,121.82,445995,416257,29738
2045-03,485895,43898,43104,13457,151785,130885,17656,5742,1951,1319,305.04,1,99.41,529793,362629,167164
2045-04,389430,38686,26131,12329,180465,154397,21539,39697,2360,3017,188.01,1,116.32,428116,434558,-6442
2045-05,106901,24088,35985,8228,112968,234987,5628,29885,1083,2671,153.66,0,116.04,130989,427681,-296692
2045-06,150051,39549,30225,6334,196824,173995,25239,31166,3175,2116,83.1,0,119.06,189600,463783,-274183
2045-07,370173,49722,40483,5173,156684,191861,29687,17788,2582,411,130.11,0,92.32,419895,441676,-21781
2045-08,128531,28585,39768,7773,99522,117870,12706,33735,3764,2696,-6.75,1,92.57,157116,311374,-154258
2045-09,381421,28656,41724,6721,140500,168061,24038,9794,1369,1609,351.26,1,80.1,410077,390838,19239
2045-10,214743,39485,30376,7419,170804,212781,9516,13622,4386,3517,109.51,1,109.44,254228,444518,-190290
2045-11,406322,17545,29254,6648,103871,179017,10191,31577,3985,1349,147.02,0,121.11,423867,360558,63309
2045-12,332352,46810,48307,5111,131659,231515,20977,21040,1924,1370,190.8,1,129.32,379162,458609,-79447
2046-01,301065,32631,37923,6229,154587,52827,17851,34125,3913,612,93.04,0,82.25,333696,303542,30154
2046-02,311868,43700,49821,10824,188557,131657,21183,23260,3182,2904,68.46,0,101.92,355568,425302,-69734
2046-03,318009,45685,28804,6453,184737,51607,29959,13782,1866,3354,197.17,1,136.92,363694,315342,48352
2046-04,322919,15131,32396,7247,126778,202568,22421,23047,2900,1566,138.24,1,81.8,338050,414457,-76407
2046-05,185850,25515,30242,5636,114569,179448,25520,15021,2153,2964,119.52,0,92.46,211365,370436,-159071
2046-06,157221,23084,42085,7780,148592,120772,28242,35426,4911,2881,32.0,0,132.73,180305,382897,-202592
2046-07,321425,18958,36590,8864,104413,224975,12920,5100,4204,2346,75.07,0,98.5,340383,392862,-52479
2046-08,163172,13925,48599,8622,119763,188255,20490,30099,1647,389,147.37,1,101.29,177097,415828,-238731
2046-09,327694,26445,22844,14277,110124,171255,22377,12429,3669,838,61.61,1,149.0,354139,353306,833
2046-10,492831,34382,48265,7675,102828,141284,22881,32485,4334,2240,84.11,1,99.4,527213,355418,171795
2046-11,472827,27199,44031,6596,107034,90694,9556,25533,3581,2886,152.07,0,141.58,500026,283444,216582
2046-12,324510,16068,37687,11213,120000,98866,23235,29376,3962,2397,137.79,1,114.26,340578,320377,20201
2047-01,118264,32472,45756,14875,165961,93327,5413,6675,1635,3847,132.09,0,136.36,150736,332007,-181271
2047-02,351908,24292,23325,12613,122830,108799,23102,5223,4381,2784,119.27,0,131.86,376200,295892,80308
2047-03,222321,16590,24100,8739,154679,143297,17713,29747,1438,403,82.78,1,96.12,238911,378275,-139364
2047-04,167723,22024,42815,14608,90762,185261,8085,37054,793,2592,181.67,1,137.49,189747,378585,-188838
2047-05,187824,31688,22518,10191,148363,227634,11157,37334,3627,355,152.76,0,146.34,219512,457197,-237685
2047-06,455973,24814,35656,12434,105089,100544,23769,34302,1574,1809,277.2,0,128.81,480787,311794,168993
2047-07,172465,29673,27610,11884,195580,136989,16882,10805,684,3194,180.87,0,109.25,202138,399750,-197612
2047-08,407420,49348,40165,7505,87475,130593,26872,31784,3413,3557,87.01,1,99.24,456768,324394,132374
2047-09,434567,45627,36269,10886,109153,231289,13055,31850,2438,3207,129.63,1,126.65,480194,432502,47692
2047-10,193043,47447,21448,7893,161349,136290,28649,38083,4355,3801,52.64,1,98.49,240490,393712,-153222
2047-11,427456,18197,37384,7833,116226,120244,7944,13754,1624,3015,279.05,0,121.67,445653,303385,142268
2047-12,455510,14123,21301,5054,90056,198115,25119,39218,3234,3311,83.61,1,112.45,469633,378863,90770
2048-01,227639,46324,42994,10010,190536,60946,6659,30969,3429,2718,154.1,0,116.2,273963,342114,-68151
2048-02,260384,12880,37701,9471,90387,210420,10360,19911,4507,473,47.53,0,100.6,273264,378250,-104986
2048-03,440839,10096,38991,6371,136706,153863,16575,22268,4895,2643,25.36,1,130.47,450935,374774,76161
2048-04,289187,28882,31386,10153,80267,117038,7302,25300,2263,3608,101.56,1,137.89,318069,271446,46623
2048-05,196851,41641,33128,8117,98247,191279,10897,16403,2430,2309,123.93,0,84.09,238492,358071,-119579
2048-06,314144,28568,38007,13495,86679,159489,18670,33495,884,3656,418.17,0,145.01,342712,349835,-7123
2048-07,386911,12126,28536,8853,144429,192053,23551,38974,1730,1027,262.41,0,98.63,399037,436396,-37359
2048-08,429255,39737,49256,5038,176085,162983,27189,29946,4699,1624,122.12,1,134.64,468992,450497,18495
2048-09,271346,24821,46148,13596,108636,148997,19750,16200,3193,3062,38.35,1,81.18,296167,353327,-57160
2048-10,314783,47722,25724,10113,118453,198808,10773,24040,2286,1305,108.13,1,120.45,362505,387911,-25406
2048-11,163391,14600,40653,14693,117878,190089,14390,18166,505,1686,447.5,0,111.63,177991,395869,-217878
2048-12,461160,29267,48927,9519,116186,177455,5025,15864,4477,3587,70.47,1,145.06,490427,372976,117451
2049-01,428302,11498,36889,9637,96392,184700,10376,18619,4911,1051,33.59,0,103.08,439800,356613,83187
2049-02,163305,46043,21467,8395,116803,232363,12890,22969,2965,2615,53.94,0,139.12,209348,414887,-205539
2049-03,426659,19027,32460,10763,116363,240159,16470,10066,4087,536,91.63,1,117.32,445686,426281,19405
2049-04,220774,31084,27130,14681,123544,116357,6751,26123,1208,1434,204.6,1,86.7,251858,314586,-62728
2049-05,377176,12687,41893,7933,177792,130996,8873,14436,2838,1262,105.85,0,137.2,389863,381923,7940
2049-06,107013,39961,26829,5775,191015,220932,29217,19784,3757,2945,57.16,0,136.81,146974,493552,-346578
2049-07,159716,40215,41788,10731,155030,72002,6093,31333,1889,1576,103.76,0,134.11,199931,316977,-117046
2049-08,125069,37020,41116,8295,124205,196474,17567,21459,634,2295,191.5,1,101.64,162089,409116,-247027
2049-09,377352,43765,23641,14716,178224,203363,28649,6718,3429,3724,125.43,1,81.98,421117,455311,-34194
2049-10,435531,47884,23729,11452,180895,168580,29211,18336,3160,605,184.34,1,83.78,483415,432203,51212
2049-11,243917,31703,35633,9900,159624,195167,28131,8744,3973,2966,160.01,0,145.05,275620,437199,-161579
2049-12,131296,39694,23052,6059,151353,190116,10516,33136,2019,2722,13.46,1,96.88,170990,414232,-243242
2050-01,115405,36095,41249,8544,188354,181963,23822,9909,1772,1684,40.9,0,141.43,151500,453841,-302341
2050-02,261094,41641,45282,6857,125463,226989,29891,36671,1948,587,133.81,0,89.24,302735,471153,-168418
2050-03,225351,33273,26175,6313,163462,149227,15831,38377,4870,2999,30.08,1,104.45,258624,399385,-140761
2050-04,166801,32425,45785,10495,138674,147175,14483,7129,1936,1742,50.37,1,97.21,199226,363741,-164515
2050-05,373038,26505,25686,8349,88439,201629,16889,11868,1423,396,325.14,0,103.8,399543,352860,46683
2050-06,123032,17794,28413,7383,97330,206466,24462,25856,2416,1888,4.33,0,142.52,140826,389910,-249084
2050-07,378161,36520,33049,12266,87945,247357,26119,39204,724,2081,510.88,0,147.72,414681,445940,-31259
2050-08,132508,38865,35303,5406,132813,62024,15704,26486,4725,2474,20.83,1,127.81,171373,277736,-106363
2050-09,478902,31365,46678,13086,100977,203496,11385,12515,3660,2571,128.27,1,80.95,510267,388137,122130
2050-10,377298,49151,43628,5182,109646,70011,18391,24149,2982,2063,134.58,1,108.67,426449,271007,155442
2050-11,210837,33018,47515,5610,108281,147918,25151,5992,3532,2110,199.16,0,119.23,243855,340467,-96612
2050-12,465191,12070,33868,14664,155726,95654,5683,25987,1698,3059,242.0,1,105.99,477261,331582,145679
2051-01,158548,10140,28746,9654,157050,169119,24035,29382,1973,2027,32.97,0,83.48,168688,417986,-249298
2051-02,310675,45499,23226,5223,150067,222840,9685,25329,4811,491,109.54,0,102.96,356174,436370,-80196
2051-03,484894,19515,43287,7349,172594,126151,20023,31241,588,2183,830.53,1,116.08,504409,400645,103764
2051-04,142399,29510,35051,10523,109232,76740,6097,31716,1633,3105,49.27,1,128.36,171909,269359,-97450
2051-05,334120,29946,46122,5258,187345,61062,22526,8793,4737,3630,150.41,0,140.05,364066,331106,32960
2051-06,436570,29426,34840,11901,176495,139015,17818,18968,4323,2304,89.73,0,119.7,465996,399037,66959
2051-07,326105,45839,35793,8539,173815,119661,29531,33398,2720,1882,181.88,0,111.18,371944,400737,-28793
2051-08,235929,34296,33348,8343,147610,108237,23695,32234,2628,2645,92.04,1,88.09,270225,353467,-83242
2051-09,247983,29633,32985,10811,197821,130230,12012,22322,4867,1309,12.06,1,128.34,277616,406181,-128565
2051-10,175540,24385,35530,6686,141342,50831,5799,36488,3163,2722,-88.77,1,142.61,199925,276676,-76751
2051-11,477987,15040,45593,13788,105791,233212,22297,14002,1679,3875,322.98,0,116.89,493027,434683,58344
2051-12,442322,40460,27625,14512,131776,53904,11880,37348,3568,3286,159.3,1,94.63,482782,277045,205737
2052-01,469038,47157,25580,9266,113691,95401,16241,39603,4201,2555,85.3,0,145.09,516195,299782,216413
2052-02,345228,29643,48878,6399,193455,168038,22206,8622,3699,1566,61.96,0,104.42,374871,447598,-72727
2052-03,124314,39805,49709,11338,121538,80642,9752,17152,3376,3971,14.24,1,123.51,164119,290131,-126012
2052-04,252318,39293,41820,11312,110607,244012,26054,39220,4165,3058,89.6,1,145.26,291611,473025,-181414
2052-05,367150,48594,39284,6758,187789,132576,9219,20322,3319,2090,94.73,0,82.35,415744,395948,19796
2052-06,112117,32370,23496,13105,142078,191683,22699,33012,795,1542,87.38,0,147.45,144487,426073,-281586
2052-07,330004,28128,32001,10552,186596,85438,27031,15160,4204,973,114.34,0,104.98,358132,356778,1354
2052-08,300883,13435,37612,14376,191547,142800,12035,25150,1432,3783,179.4,1,139.01,314318,423520,-109202
2052-09,357010,29070,31113,14241,169147,108849,21141,30624,2961,2833,114.03,1,90.5,386080,375115,10965
2052-10,475150,15952,29910,9661,156500,135417,11934,16057,3318,1748,123.32,1,115.03,491102,359479,131623
2052-11,284814,39787,38342,13830,103048,184612,18950,38549,1963,3301,130.67,0,120.07,324601,397331,-72730
2052-12,487831,27335,25889,5077,185227,78575,25417,25850,996,3033,435.34,1,121.05,515166,346035,169131
2053-01,440777,43739,44268,8499,122541,209693,7018,9415,3387,1047,56.21,0,114.32,484516,401434,83082
2053-02,426885,13879,47048,12845,98836,196640,27945,30124,2868,3503,91.74,0,97.54,440764,413438,27326
2053-03,324405,35330,45461,5480,141154,199550,10918,22000,1471,370,156.27,1,89.53,359735,424563,-64828
2053-04,132701,18054,40480,10379,167226,205343,17870,5470,612,2689,226.37,1,117.03,150755,446768,-296013
2053-05,166691,31930,45591,6868,80590,186378,27047,11749,2402,1909,48.16,0,106.44,198621,358223,-159602
2053-06,128265,22087,24906,8909,98267,65964,6096,30654,2589,390,84.14,0,98.94,150352,234796,-84444
2053-07,112505,23890,32680,10637,106224,70163,15661,13581,3556,2861,-11.01,0,81.99,136395,248946,-112551
2053-08,243639,47961,37250,5240,127362,136624,12406,12095,1064,1994,214.41,1,116.7,291600,330977,-39377
2053-09,422223,42946,47565,12610,100228,197765,16432,6963,714,1033,508.64,1,82.5,465169,381563,83606
2053-10,134394,35828,24382,9548,174935,80821,10549,24786,3106,324,59.69,1,138.67,170222,325021,-154799
2053-11,275044,30782,46876,11827,175248,86114,15424,34605,4171,3396,5.88,0,138.57,305826,370094,-64268
2053-12,419129,38061,49762,5438,184229,164213,11371,16058,2991,597,96.06,1,112.04,457190,431071,26119
2054-01,439267,32123,35829,6021,182452,135395,11412,32380,1887,1447,203.12,0,95.21,471390,403489,67901
2054-02,449402,24426,39610,7085,143350,75310,7597,28685,2694,1376,52.53,0,110.47,473828,301637,172191
2054-03,102161,33627,39786,10335,93082,240733,15602,31610,4446,957,30.93,1,80.87,135788,431148,-295360
2054-04,188885,15074,35597,5678,124643,60442,29951,24047,2618,1881,62.31,1,109.75,203959,280358,-76399
2054-05,238161,38979,39085,7764,162382,200520,5486,12197,4330,1699,72.92,0,121.79,277140,427434,-150294
2054-06,450371,15166,21279,14228,145418,93853,24894,13641,2421,1922,202.27,0,95.11,465537,313313,152224
2054-07,482327,14271,31495,10750,125609,165066,5720,38608,2884,391,145.71,0,130.02,496598,377248,119350
2054-08,215510,17395,25092,10256,132560,183976,28606,5125,2110,3521,110.09,1,119.66,232905,385615,-152710
2054-09,300350,22940,30427,5234,182800,247723,18548,25991,4558,1060,121.86,1,86.55,323290,510723,-187433
2054-10,181071,49022,36153,9095,101630,176606,27870,16515,3840,1433,131.46,1,104.01,230093,367869,-137776
2054-11,142915,36132,43177,10704,139085,156287,11961,5193,3283,3687,21.02,0,134.64,179047,366407,-187360
2054-12,404229,14457,37841,13672,112393,244281,8760,6174,1471,882,413.11,1,129.22,418686,423121,-4435
2055-01,130049,44651,46817,14210,101199,235465,11092,13287,1865,906,9.37,0,121.67,174700,422070,-247370
2055-02,207459,44028,33978,7783,133620,101885,7556,10780,4121,1027,139.39,0,146.3,251487,295602,-44115
2055-03,145473,49863,27272,6015,197595,249032,22242,19713,4864,397,37.99,1,149.51,195336,521869,-326533
2055-04,403566,10686,27876,12575,158635,225435,18067,30712,3928,3167,131.82,1,88.32,414252,473300,-59048
2055-05,172233,35577,35585,11422,180072,151109,11993,17461,908,3254,135.08,0,91.06,207810,407642,-199832
2055-06,191872,18915,33502,5696,140509,106971,11504,38301,703,3990,334.6,0,97.55,210787,336483,-125696
2055-07,482441,44380,30850,9308,82866,131851,26571,39547,3597,3365,178.28,0,132.53,526821,320993,205828
2055-08,465407,41396,25374,9529,146918,122956,9884,12033,3228,1505,147.03,1,135.08,506803,326694,180109
2055-09,132815,29834,24322,6747,112746,228689,16276,9631,1605,3442,138.71,1,120.71,162649,398411,-235762
2055-10,100928,19438,27576,11161,137874,164588,13454,11723,2631,2656,16.76,1,85.3,120366,366376,-246010
2055-11,193655,45091,24752,8235,94939,169274,27853,10113,3829,803,53.21,0,104.78,238746,335166,-96420
2055-12,287980,13023,46078,9897,102999,247978,13446,7063,3702,2534,69.63,1,143.71,301003,427461,-126458
2056-01,385384,47229,49391,8317,169670,191132,21356,5086,1047,1852,445.14,0,132.32,432613,444952,-12339
2056-02,271272,39612,37817,11105,82113,229289,23884,14403,1108,2330,271.36,0,122.62,310884,398611,-87727
2056-03,411788,23640,32912,8968,132814,80205,5872,27087,2155,1199,169.12,1,104.12,435428,287858,147570
2056-04,394425,47570,38240,14030,91493,82407,9544,6502,1498,665,247.52,1,149.97,441995,242216,199779
2056-05,313383,11498,40359,12096,132546,248536,20583,8451,3199,2376,53.0,0,113.01,324881,462571,-137690
2056-06,337984,18056,44653,7368,169817,172768,14839,39522,1715,1510,261.74,0,85.51,356040,448967,-92927
2056-07,138445,45712,49828,13971,173106,84847,7144,30174,2060,2125,112.37,0,143.2,184157,359070,-174913
2056-08,490329,40899,23412,8797,155971,124310,5658,33829,3163,991,127.85,1,80.12,531228,351977,179251
2056-09,444070,30574,37698,13938,165528,131351,14858,8222,4767,810,139.67,1,116.66,474644,371595,103049
2056-10,230569,47955,32063,13088,104712,232783,21612,28139,4421,2548,77.32,1,100.37,278524,432397,-153873
2056-11,182297,35004,35470,9469,161351,96155,23428,18742,2911,2015,-90.86,0,112.16,217301,344615,-127314
2056-12,438494,26653,26851,13942,139886,165963,19408,27415,4867,889,210.89,1,119.07,465147,393465,71682
2057-01,308531,39862,42977,7106,107946,90585,27918,11095,3902,1425,102.34,0,130.81,348393,287627,60766
2057-02,397666,15561,31528,11791,99098,166063,29671,6267,848,1917,428.18,0,148.53,413227,344418,68809
2057-03,172525,16584,37504,12980,171041,200389,22311,19537,4479,901,20.46,1,92.26,189109,463762,-274653
2057-04,347470,12780,44974,10721,117904,159413,29263,27557,4127,1341,31.63,1,83.55,360250,389832,-29582
2057-05,274967,15251,31304,7552,90080,168015,24846,14945,4076,1822,98.97,0,97.08,290218,336742,-46524
2057-06,322669,30782,40653,6349,82576,84852,19851,13715,1560,1357,222.05,0,92.02,353451,247996,105455
2057-07,100596,47818,31403,9027,127342,167451,26084,11265,1642,3795,59.73,0,135.96,148414,372572,-224158
2057-08,364037,18976,37373,14457,148935,56709,6759,11117,3172,692,158.14,1,140.14,383013,275350,107663
2057-09,199744,16386,48444,8981,167934,111709,17107,30718,4374,3399,35.11,1,85.0,216130,384893,-168763
2057-10,205512,13444,26670,9701,125509,58133,23836,36957,4047,3353,61.08,1,130.77,218956,280806,-61850
2057-11,245343,30745,40989,13356,139784,234951,13732,6722,973,1376,266.81,0,124.6,276088,449534,-173446
2057-12,488021,20487,45699,9386,169589,127191,6304,6848,4974,3926,83.41,1,105.97,508508,365017,143491
2058-01,394741,40018,47266,11561,108842,202098,12864,12357,1323,2942,328.62,0,85.18,434759,394988,39771
2058-02,480557,31867,26661,11467,168300,130813,24783,38443,3547,3436,143.73,0,128.17,512424,400467,111957
2058-03,494368,48098,41420,14230,129634,136472,13985,32300,3444,2212,231.85,1,92.67,542466,368041,174425
2058-04,415958,26300,45759,13439,162384,59849,5586,19974,2945,3309,124.06,1,105.66,442258,306991,135267
2058-05,492450,43170,46833,12735,102245,136090,19166,9323,4466,2894,46.79,0,132.21,535620,326392,209228
2058-06,123023,43482,45282,12719,110085,177628,28386,17595,3743,1435,8.26,0,137.73,166505,391695,-225190
2058-07,215643,40032,33620,13812,107310,225274,18663,6178,3104,3341,60.42,0,113.13,255675,404857,-149182
2058-08,287013,35479,27267,6069,83111,175862,23536,6274,1808,1388,60.18,1,145.18,322492,322119,373
2058-09,259075,16382,34147,8609,105848,147086,8683,9302,4930,3632,95.69,1,86.56,275457,313675,-38218
2058-10,196896,24668,20140,5729,132293,243800,21615,19711,4094,1124,0.61,1,124.8,221564,443288,-221724
2058-11,141380,20633,47605,5776,95095,183995,12668,30266,2595,3250,77.75,0,85.26,162013,375405,-213392
2058-12,188036,32319,44475,9613,150744,196513,11159,23466,578,460,358.0,1,97.93,220355,435970,-215615
2059-01,208884,11941,30715,9976,133724,101610,23657,20821,4783,3627,10.33,0,122.83,220825,320503,-99678
2059-02,283565,46719,42169,11421,199033,179483,23131,18750,2040,2455,91.98,0,136.48,330284,473987,-143703
2059-03,202992,43682,28296,12465,118146,163233,19392,7409,4894,3134,73.93,1,123.93,246674,348941,-102267
2059-04,455441,12946,21226,14717,102874,188497,23443,21058,3620,2399,139.67,1,90.75,468387,371815,96572
2059-05,125759,18831,27565,11626,137283,113418,5470,26104,2145,381,103.79,0,145.87,144590,321466,-176876
2059-06,286039,34572,22585,5285,120678,108355,16802,33809,4124,2952,39.6,0,84.92,320611,307514,13097
2059-07,437561,24442,37227,9600,175957,52258,15748,32963,2604,880,112.64,0,102.47,462003,323753,138250
2059-08,233419,21844,35366,5379,118715,118508,11901,24787,4046,1172,-2.35,1,146.61,255263,314656,-59393
2059-09,226099,39880,32827,6476,166720,236692,13085,38429,3676,1470,80.27,1,129.19,265979,494229,-228250
2059-10,192178,42973,34011,11910,180454,82739,27258,20294,2655,3033,57.46,1,128.58,235151,356666,-121515
2059-11,362156,44022,44778,7684,118736,138088,10540,13811,817,1277,312.69,0,142.62,406178,333637,72541
2059-12,242221,38931,34309,12175,132122,135475,13340,24733,1787,653,125.56,1,140.3,281152,352154,-71002
2060-01,177531,27158,37762,8968,166396,199313,19697,19697,3369,1588,113.23,0,141.52,204689,451833,-247144
2060-02,413806,36440,33378,11637,175721,227721,22233,30598,3487,733,143.99,0,89.83,450246,501288,-51042
2060-03,478078,17477,37716,6292,189100,58473,10384,27451,3029,2948,227.04,1,117.12,495555,329416,166139
2060-04,301821,20929,27680,11164,119128,230529,19330,18676,3842,1115,132.64,1,95.46,322750,426507,-103757
2060-05,448299,26574,27689,12609,104314,241142,11749,30360,4795,1784,8.17,0,143.74,474873,427863,47010
2060-06,434057,40333,42644,13663,130094,63138,27775,27546,612,489,684.4,0,94.32,474390,304860,169530
2060-07,131900,29483,49630,14116,178265,234532,17896,31019,580,2505,247.01,0,131.81,161383,525458,-364075
2060-08,459946,25773,27978,7907,156353,233549,22926,18290,3084,1645,201.33,1,104.86,485719,467003,18716
2060-09,378437,17232,24295,14557,173460,81229,18011,19844,3991,2197,60.03,1,92.77,395669,331396,64273
2060-10,428545,29698,43176,12018,93435,95676,23698,29042,4064,2498,132.66,1,99.75,458243,297045,161198
2060-11,145749,26548,34554,11787,123760,209802,28550,35103,2809,1634,39.31,0,128.39,172297,443556,-271259
2060-12,352489,46563,24114,11609,162072,173637,16710,25233,503,2132,704.68,1,115.64,399052,413375,-14323
2061-01,257874,46776,25038,11022,83717,174279,8631,18257,1190,1663,162.57,0,98.95,304650,320944,-16294
2061-02,435025,17891,25752,10202,84592,188678,21019,26480,3623,3583,85.67,0,85.94,452916,356723,96193
2061-03,206335,16277,21918,5708,160858,95889,24904,25516,4708,3010,60.6,1,113.1,222612,334793,-112181
2061-04,385660,47956,26929,8594,149154,161854,17068,10712,3416,1172,164.43,1,145.59,433616,374311,59305
2061-05,188751,42106,37336,9538,170655,151738,12989,8480,2390,1045,76.33,0,117.66,230857,390736,-159879
2061-06,335307,31355,28351,14313,135399,173240,25583,29776,4551,1512,34.61,0,132.65,366662,406662,-40000
2061-07,284440,44141,35404,5001,171330,211827,24475,27996,1524,3443,171.79,0,136.32,328581,476033,-147452
2061-08,206870,43609,22673,6521,131170,132623,24160,6464,1227,3103,136.59,1,106.54,250479,323611,-73132
2061-09,161581,34570,49188,12662,188496,91680,25418,21212,2343,3995,83.68,1,119.32,196151,388656,-192505
2061-10,245795,45220,25050,12758,122184,85782,13362,19548,2915,3824,112.71,1,99.08,291015,278684,12331
2061-11,163341,39552,23545,5262,138297,86736,20389,33095,4296,2227,71.32,0,126.38,202893,307324,-104431
2061-12,291587,35377,29820,6127,156299,88434,22933,31736,2363,3868,123.95,1,142.52,326964,335349,-8385
2062-01,315541,33392,29001,14456,166149,239723,19719,12585,740,2548,467.71,0,135.25,348933,481633,-132700
2062-02,213118,30608,48075,5344,173658,81947,14032,9125,3445,1356,10.22,0,113.76,243726,332181,-88455
2062-03,114738,22427,41241,6030,138987,225561,19167,35218,4735,2795,-92.5,1,105.69,137165,466204,-329039
2062-04,199698,43143,27003,11021,88400,175656,7285,23644,4065,2739,107.83,1,145.64,242841,333009,-90168
2062-05,271831,27727,38091,5967,98634,167302,21688,5477,4680,764,68.36,0,91.62,299558,337159,-37601
2062-06,499957,23524,44434,7464,95654,222421,17142,23241,3093,1079,124.33,0,104.38,523481,410356,113125
2062-07,363135,20808,46074,10026,160101,75947,6724,15384,712,1978,499.67,0,91.73,383943,314256,69687
2062-08,226787,21855,40499,8329,100893,210202,19180,7375,1571,3568,134.84,1,128.17,248642,386478,-137836
2062-09,349480,47722,34468,13387,142194,154301,13803,32352,2768,2806,108.99,1,98.76,397202,390505,6697
2062-10,287757,13622,40796,10874,130387,50101,29125,18495,2546,1015,101.32,1,132.43,301379,279778,21601
2062-11,313283,49246,23048,13413,184735,68155,22505,20112,3951,1558,109.05,0,126.35,362529,331968,30561
2062-12,445915,29746,46365,12466,152034,195349,22018,39914,1404,2786,311.11,1,86.97,475661,468146,7515
2063-01,234201,36619,29783,9795,159835,179723,11590,13645,4273,3455,-24.71,0,128.85,270820,404371,-133551
2063-02,279179,15779,34265,12278,129595,168460,11231,9150,4935,2449,145.12,0,112.53,294958,364979,-70021
2063-03,150491,32711,24591,5516,108879,246450,13905,7449,4830,1096,-56.38,1,133.07,183202,406790,-223588
2063-04,443778,14877,47510,13343,146799,95990,9775,35123,2155,1292,163.4,1,107.77,458655,348540,110115
2063-05,488748,17320,45338,9402,83501,118628,7573,9156,1752,443,147.9,0,139.44,506068,273598,232470
2063-06,497518,40955,42845,7376,92405,236911,10683,37321,3003,3668,304.86,0,111.76,538473,427541,110932
2063-07,492052,24633,30489,8160,84107,222799,29275,31007,3781,1056,179.79,0,117.33,516685,405837,110848
2063-08,245559,36653,28624,12204,128804,57251,15701,39144,3299,1279,-35.78,1,84.77,282212,281728,484
2063-09,184883,44913,29764,7278,161490,240254,26470,30948,4570,2539,91.33,1,86.94,229796,496204,-266408
2063-10,242677,25934,22822,7345,191920,82887,20474,27470,1705,2374,88.26,1,121.58,268611,352918,-84307
2063-11,243079,10695,26007,7247,184863,61624,11353,25606,3334,2341,91.06,0,96.82,253774,316700,-62926
2063-12,340180,40060,31650,13120,123672,88712,13204,21856,1466,1065,357.14,1,121.91,380240,292214,88026
2064-01,116694,47933,26490,10971,137229,112776,8704,39640,4285,1407,36.7,0,128.09,164627,335810,-171183
2064-02,304541,48657,40525,9861,158260,73993,12435,11115,901,1546,309.49,0,105.33,353198,306189,47009
2064-03,431143,49673,29830,8949,143914,74115,13166,34566,3250,1341,106.72,1,129.96,480816,304540,176276
2064-04,331991,30449,31880,13987,197256,189551,8773,21289,3117,1285,157.07,1,101.88,362440,462736,-100296
2064-05,388216,14618,36423,14866,198627,78858,12760,12764,4055,1134,117.26,0,135.12,402834,354298,48536
2064-06,150000,18343,46805,7927,175692,202953,15256,13601,4049,1126,25.76,0,130.44,168343,462234,-293891
2064-07,409025,19363,26592,6877,151410,58107,12636,23984,4746,3752,12.28,0,117.47,428388,279606,148782
2064-08,487762,41691,35778,7934,105889,90535,7927,21412,3712,3909,74.94,1,125.69,529453,269475,259978
2064-09,472433,34907,40072,11497,127992,225552,14416,7887,2318,914,155.8,1,133.13,507340,427416,79924
2064-10,151401,38321,24735,5094,187340,205847,20828,21545,3927,2883,165.97,1,126.47,189722,465389,-275667
2064-11,259940,31011,23764,5698,170245,214290,25961,39588,3701,603,56.12,0,101.42,290951,479546,-188595
2064-12,424450,34671,24391,8318,82703,174292,5883,35896,1450,683,358.75,1,92.42,459121,331483,127638
2065-01,209607,14319,44569,6210,189014,105907,17068,13481,3591,1785,33.55,0,102.55,223926,376249,-152323
2065-02,184209,44145,49397,12031,127193,72663,21075,8285,3260,3740,85.36,0,107.02,228354,290644,-62290
2065-03,103365,42108,48671,6820,151697,105395,20951,7242,3946,3439,14.48,1,82.62,145473,340776,-195303
2065-04,129412,41879,32541,12658,105151,154002,23653,16612,3232,3856,73.44,1,133.69,171291,344617,-173326
2065-05,277902,29089,31390,12559,135387,66457,29180,30730,1056,2012,315.2,0,81.74,306991,305703,1288
2065-06,242897,18942,23978,9525,99976,92505,16336,7154,2801,968,57.98,0,107.3,261839,249474,12365
2065-07,495500,33776,33397,11858,175057,92913,15572,13390,3222,2544,161.24,0,93.8,529276,342187,187089
2065-08,410882,29443,32381,10133,183271,206928,19313,23874,1117,1468,392.2,1,126.04,440325,475900,-35575
2065-09,354663,18536,20768,14899,105379,80676,13623,31282,1608,2053,208.86,1,139.57,373199,266627,106572
2065-10,186189,24599,38061,12202,115125,227811,27823,33348,4773,2989,118.32,1,85.34,210788,454370,-243582
2065-11,371840,43331,30170,9804,169075,77107,23691,5226,2314,2249,238.98,0,93.75,415171,315073,100098
2065-12,228616,25530,42227,9891,195539,75514,29804,17997,2201,1659,78.24,1,120.95,254146,370972,-116826
2066-01,277828,23586,22484,9680,170783,71830,22133,33181,3441,2230,-12.68,0,115.56,301414,330091,-28677
2066-02,227190,47416,39422,13502,96749,149045,15676,38694,2703,1633,146.37,0,94.74,274606,353088,-78482
2066-03,476003,15430,47567,10847,162647,170443,7128,36597,4487,3060,59.94,1,110.08,491433,435229,56204
2066-04,287324,29379,35583,9723,80853,116589,13261,17235,1556,2529,193.16,1,95.08,316703,273244,43459
2066-05,238117,13238,35432,14190,130832,155739,10666,28125,3665,3115,63.92,0,92.68,251355,374984,-123629
2066-06,138058,40622,25047,14911,188784,221830,22826,8686,2280,985,123.44,0,144.72,178680,482084,-303404
2066-07,382774,24571,40341,9707,178795,179349,18087,7852,1607,3517,216.42,0,123.78,407345,434131,-26786
2066-08,133331,13132,44775,9477,191619,168487,25139,24767,2476,2648,58.26,1,116.11,146463,464264,-317801
2066-09,316288,14147,34384,10899,155173,90871,22198,35524,1163,2812,272.46,1,80.75,330435,349049,-18614
2066-10,418505,47036,23056,10669,109097,226591,8409,37649,4974,3009,66.48,1,115.82,465541,415471,50070
2066-11,365322,21294,24838,10355,192873,243150,26943,38337,2394,1970,121.83,0,144.45,386616,536496,-149880
2066-12,369680,21416,46769,13639,173446,187130,19439,31313,2216,410,229.92,1,124.92,391096,471736,-80640
2067-01,207516,43103,32055,12693,84783,187785,22559,29842,1447,403,138.46,0,88.09,250619,369717,-119098
2067-02,330204,35893,39935,14649,126456,205978,16077,24306,3266,3815,128.35,0,80.37,366097,427401,-61304
2067-03,309994,42821,35060,5680,86657,188070,9997,20955,4443,2819,131.72,1,111.77,352815,346419,6396
2067-04,446974,31340,39205,14604,176575,81300,20142,36330,2133,2195,201.8,1,125.82,478314,368156,110158
2067-05,125609,35061,20967,8200,136038,60791,27413,15125,1941,2719,-20.49,0,139.16,160670,268534,-107864
2067-06,127339,41158,27668,14705,161525,143008,24253,26543,2648,3054,6.02,0,87.4,168497,397702,-229205
2067-07,321110,16385,44069,10709,166532,62217,6422,8558,3996,999,57.86,0,103.38,337495,298507,38988
2067-08,101658,25571,27632,7938,83524,91644,14112,22941,3577,1953,-85.25,1,116.16,127229,247791,-120562
2067-09,220767,18022,27844,9637,174781,178095,22155,27142,1385,3171,243.07,1,105.71,238789,439654,-200865
2067-10,416828,25288,47518,11275,106362,120531,16591,10993,3467,1508,167.02,1,88.3,442116,313270,128846
2067-11,351951,32117,48570,12896,154680,226400,19546,39484,735,2281,551.25,0,107.47,384068,501576,-117508
2067-12,339015,36165,27083,12729,85956,57259,18102,29671,1162,2154,315.4,1,149.86,375180,230800,144380
2068-01,225875,32236,27786,9915,105135,107022,8290,5414,1882,3098,44.4,0,95.52,258111,263562,-5451
2068-02,240729,12454,49201,9710,132505,74723,23921,33443,1974,3106,64.02,0,104.5,253183,323503,-70320
2068-03,459336,42163,34328,7821,90300,209795,22275,9311,4201,3271,117.74,1,101.62,501499,373830,127669
2068-04,240214,34937,38017,5471,170445,205531,27181,33116,2661,1385,92.55,1,84.27,275151,479761,-204610
2068-05,450408,46422,36066,5638,177198,163677,13830,36121,4595,2472,66.43,0,118.55,496830,432530,64300
2068-06,369807,10569,42954,7646,195623,59860,13832,21428,4118,2926,93.39,0,129.92,380376,341343,39033
2068-07,364881,40636,44699,11107,80847,68248,23666,23802,1032,3221,392.66,0,122.04,405517,252369,153148
2068-08,420002,49407,46709,11908,183954,209259,25105,28249,1872,3354,221.94,1,87.44,469409,505184,-35775
2068-09,380589,35586,29542,11339,130636,87386,17389,16020,4631,2119,97.6,1,101.45,416175,292312,123863
2068-10,126376,21134,46004,14690,197148,121605,22714,7022,3064,2138,22.3,1,128.64,147510,409183,-261673
2068-11,461388,46184,42880,12834,128964,239889,16232,14144,599,1017,740.47,0,131.96,507572,454943,52629
2068-12,356242,40072,28202,7497,171121,172615,28734,13674,3691,641,102.84,1,122.19,396314,421843,-25529
2069-01,377277,32969,31871,9023,184114,109228,12976,35104,1019,2815,424.76,0,112.91,410246,382316,27930
2069-02,276241,49656,30980,14687,137111,142037,16970,28876,2146,1716,79.48,0,144.44,325897,370661,-44764
2069-03,136732,24296,29395,14726,118795,194070,11466,21832,2388,678,27.47,1,82.39,161028,390284,-229256
2069-04,215221,12717,41216,9657,174613,223955,29724,9504,4083,2122,5.2,1,132.55,227938,488669,-260731
2069-05,327618,28403,21490,14363,121400,118990,19721,8279,2063,1696,109.63,0,91.85,356021,304243,51778
2069-06,398413,23958,41494,11914,80900,171112,10602,7982,2605,3989,171.72,0,105.31,422371,324004,98367
2069-07,388856,43037,45209,7773,135642,225959,11339,14796,4624,1220,15.75,0,138.28,431893,440718,-8825
2069-08,311768,45962,48326,13650,181404,209260,24114,24934,1258,2968,263.74,1,127.88,357730,501688,-143958
2069-09,441419,21023,30872,12337,191531,190649,18446,23089,822,1718,530.59,1,149.11,462442,466924,-4482
2069-10,446473,37021,33180,7687,192637,85836,13040,9512,1556,3455,315.68,1,93.65,483494,341892,141602
2069-11,259782,40241,31296,14426,174642,66633,25717,18905,3611,2870,106.49,0,132.27,300023,331619,-31596
2069-12,345849,48306,31230,14127,196261,223026,24079,25077,2466,744,87.39,1,134.56,394155,513800,-119645
2070-01,157159,28725,31518,6928,192676,109756,20144,6830,4401,1202,62.3,0,118.97,185884,367852,-181968
2070-02,460752,25466,20405,7424,164592,81918,19968,7033,4719,342,123.63,0,85.48,486218,301340,184878
2070-03,191971,30860,42257,10807,108116,161306,25532,31845,4415,521,13.53,1,138.67,222831,379863,-157032
2070-04,484061,36673,48430,5228,103955,50156,28650,27382,2118,1537,184.42,1,141.24,520734,263801,256933
2070-05,124257,14289,39913,14868,178711,71640,13824,5862,946,3275,205.02,0,111.85,138546,324818,-186272
2070-06,301726,44724,34401,11648,120983,131104,19474,16005,1299,2479,246.87,0,138.66,346450,333615,12835
2070-07,152815,16601,30511,5836,120720,189898,16252,33847,3568,2245,43.67,0,116.95,169416,397064,-227648
2070-08,384707,33004,25195,9105,118622,193023,26464,8051,3037,964,121.79,1,113.45,417711,380460,37251
2070-09,121958,28130,43506,7924,84661,103075,12706,20106,658,2557,122.51,1,144.87,150088,271978,-121890
2070-10,288325,10892,47492,7087,121060,229054,9688,21338,2471,3611,127.32,1,145.93,299217,435719,-136502
2070-11,150466,13419,36112,12353,156820,199653,26510,16163,1799,2240,56.35,0,120.56,163885,447611,-283726
2070-12,463411,28970,22370,14969,134988,166465,17882,28278,3559,3065,37.11,1,145.61,492381,384952,107429
2071-01,426809,22786,23818,10995,137715,180498,15178,7699,2266,2766,273.3,0,119.84,449595,375903,73692
2071-02,401101,33436,47905,11203,101034,227610,16712,28547,1147,2489,305.74,0,134.44,434537,433011,1526
2071-03,189693,48216,25997,6680,121112,68758,23223,11728,1720,1908,170.18,1,97.65,237909,257498,-19589
2071-04,119815,39066,29428,12750,133489,131791,15944,8935,2743,825,70.77,1,126.31,158881,332337,-173456
2071-05,407603,26266,33233,14218,155686,207828,6849,18868,3918,3667,185.54,0,149.61,433869,436682,-2813
2071-06,192683,11267,22543,11239,173084,105954,20964,35134,2630,3744,53.73,0,129.24,203950,368918,-164968
2071-07,120056,46527,34571,7831,106738,118057,19404,19862,1821,2301,49.33,0,96.25,166583,306463,-139880
2071-08,209996,27803,33282,11289,131318,113236,29090,25250,4279,1996,-73.41,1,105.23,237799,343465,-105666
2071-09,330804,26432,26820,10095,177989,237788,25997,25934,4224,3764,124.73,1,125.73,357236,504623,-147387
2071-10,192041,15551,23891,8116,120169,184855,25239,15479,3788,1260,34.76,1,111.41,207592,377749,-170157
2071-11,236711,32797,42459,11214,83977,142620,22176,19387,3113,329,114.59,0,131.41,269508,321833,-52325
2071-12,486556,15350,26958,5085,105117,132571,18471,8393,953,1948,459.11,1,123.85,501906,296595,205311
2072-01,179762,20793,45413,6337,145062,104694,24097,18051,1900,3954,73.63,0,110.11,200555,343654,-143099
2072-02,218986,40350,39213,10926,196438,174034,26972,14926,2738,2707,-27.48,0,116.64,259336,462509,-203173
2072-03,481263,48385,45288,12760,83158,156348,21736,31275,2990,2885,176.67,1,117.27,529648,350565,179083
2072-04,448548,39443,20315,5825,144117,162604,17142,28649,4497,2607,144.49,1,137.23,487991,378652,109339
2072-05,361143,21691,33527,5816,166424,165321,28091,33410,2951,3670,87.39,0,119.57,382834,432589,-49755
2072-06,153115,35315,20768,14754,167337,129542,12902,36992,2628,1035,-10.94,0,102.2,188430,382295,-193865
2072-07,327815,43316,21275,7939,130881,213694,10899,21808,3822,794,54.43,0,132.18,371131,406496,-35365
2072-08,235647,21444,43739,9778,196808,206124,24221,31781,4728,1359,65.25,1,82.77,257091,512451,-255360
2072-09,313391,36467,43252,13156,159607,220691,26800,5046,2252,3071,233.54,1,144.81,349858,468552,-118694
2072-10,130403,33830,45436,13825,149863,180375,5677,26515,3581,1568,-35.86,1,86.05,164233,421691,-257458
2072-11,431579,24833,21506,12780,175210,225216,20334,39018,4874,3719,63.15,0,123.51,456412,494064,-37652
2072-12,214125,39371,20673,6449,94595,187292,22136,29150,2213,2444,100.41,1,81.5,253496,360295,-106799
2073-01,473845,12505,30170,12034,178070,57700,26398,8369,2523,1510,168.24,0,132.26,486350,312741,173609
2073-02,250205,49987,21651,14555,141135,183750,5727,29354,1950,1983,96.6,0,97.98,300192,396172,-95980
2073-03,235351,27560,46833,13117,124331,57646,22912,12386,3395,2034,32.99,1,142.82,262911,277225,-14314
2073-04,385414,23881,49188,9801,164969,94590,24501,20984,3147,3021,27.85,1,123.38,409295,364033,45262
2073-05,143345,46181,34990,6224,123005,233207,13703,26518,4870,3202,-13.89,0,94.73,189526,437647,-248121
2073-06,252162,26486,47766,5256,187746,239652,21752,19537,2608,1719,53.92,0,129.9,278648,521709,-243061
2073-07,252211,27931,44098,10706,142706,95119,15355,11211,729,531,433.22,0,119.05,280142,319195,-39053
2073-08,345356,25442,41068,5060,167446,57100,10872,23977,3408,1600,207.0,1,98.35,370798,305523,65275
2073-09,225823,47235,42335,6492,180478,94437,16268,8224,2056,3866,130.89,1,105.79,273058,348234,-75176
2073-10,168464,35389,30731,11901,145092,91919,18350,5297,756,2062,251.7,1,149.25,203853,303290,-99437
2073-11,497401,21188,49822,14692,190759,151897,29655,32925,1181,1273,483.42,0,148.62,518589,469750,48839
2073-12,130195,42363,33384,13038,190767,110640,26532,12053,3148,531,27.28,1,80.24,172558,386414,-213856
2074-01,315020,44992,43896,5088,176635,204497,21588,37382,2338,2726,199.45,0,92.72,360012,489086,-129074
2074-02,389194,21028,41882,10275,134302,178409,28763,6777,3815,763,108.26,0,126.56,410222,400408,9814
2074-03,305109,47389,41508,7464,108152,137344,16310,32132,2087,2066,150.83,1,90.12,352498,342910,9588
2074-04,438534,21519,30097,13827,82369,79504,24190,19060,3004,3652,194.29,1,104.12,460053,249047,211006
2074-05,280311,37850,39595,9619,163476,129889,26715,34008,510,2683,576.39,0,112.93,318161,403302,-85141
2074-06,215419,35079,26017,13262,165175,148527,5598,8548,2981,310,10.84,0,81.34,250498,367127,-116629
2074-07,481288,19738,28670,7384,192954,234067,17412,20119,2857,3983,159.01,0,108.83,501026,500606,420
2074-08,406881,34140,23105,12621,193282,87675,7588,33784,1696,1844,171.03,1,83.69,441021,358055,82966
2074-09,194308,30825,40795,6722,124729,179318,8887,11439,4860,3468,11.64,1,125.51,225133,371890,-146757
2074-10,340396,27418,34042,14052,181289,170251,19861,7113,3146,1751,80.55,1,134.11,367814,426608,-58794
2074-11,339445,47702,22190,7645,129345,161267,6594,31212,824,2481,436.36,0,108.23,387147,358253,28894
2074-12,181190,28688,46822,5705,81987,141753,29528,26607,4866,2126,95.02,1,135.21,209878,332402,-122524
2075-01,115605,30612,30997,10344,109262,243817,14883,34685,997,3264,100.8,0,136.8,146217,443988,-297771
2075-02,109031,37338,37567,11062,111936,189982,11462,7313,4200,3490,16.66,0,81.31,146369,369322,-222953
2075-03,441696,24586,48628,13859,193370,191227,29653,38245,3652,3357,102.63,1,81.49,466282,514982,-48700
2075-04,186871,28005,24797,9707,143721,234191,13375,6809,1731,3967,47.93,1,132.48,214876,432600,-217724
2075-05,205184,13117,22550,12687,91512,112281,24853,18123,4337,681,-44.43,0,87.61,218301,282006,-63705
2075-06,260700,22163,45594,6586,87880,192208,27677,39254,2287,637,160.26,0,135.8,282863,399199,-116336
2075-07,221809,18487,23473,14271,107296,90835,8378,21832,4689,3975,29.72,0,146.82,240296,266085,-25789
2075-08,133433,22235,38893,12637,97509,158396,7904,31210,1039,2072,164.89,1,125.07,155668,346549,-190881
2075-09,191132,27670,28699,10088,118401,158417,5987,7351,3671,2225,40.76,1,82.14,218802,328943,-110141
2075-10,402721,33489,35978,13686,133322,140704,9059,11684,3781,1786,118.96,1,122.47,436210,344433,91777
2075-11,258144,22761,28199,10518,157023,146782,6501,31494,1708,3274,42.94,0,131.34,280905,380517,-99612
2075-12,450239,17526,32488,10059,96315,162174,10011,7655,4750,1016,86.15,1,145.87,467765,318702,149063
2076-01,352228,47889,34743,9832,103468,192773,25305,10464,664,3509,571.27,0,116.33,400117,376585,23532
2076-02,217978,11177,40068,8241,113046,192989,13469,8448,1963,2463,173.68,0,114.04,229155,376261,-147106
2076-03,374425,41565,29176,8189,109052,249740,8233,14847,2550,3405,139.23,1,131.43,415990,419237,-3247
2076-04,301622,41764,28604,11688,148331,109166,24620,9519,1459,919,207.95,1,80.08,343386,331928,11458
2076-05,472638,20558,35023,11212,190115,215694,27732,16520,2112,2752,129.83,0,112.74,493196,496296,-3100
2076-06,318507,44916,24290,12586,122421,105772,18204,39928,1096,1626,291.57,0,120.3,363423,323201,40222
2076-07,411670,10380,49811,14478,93750,88186,6373,11536,1172,856,373.31,0,122.29,422050,264134,157916
2076-08,405339,35466,44303,14910,87957,52438,25012,15382,1443,914,207.18,1,123.29,440805,240002,200803
2076-09,417999,43621,20194,7865,198849,188387,15384,39734,3244,2412,186.32,1,86.53,461620,470413,-8793
2076-10,367720,11185,35712,6286,87981,95588,18588,32278,2157,2021,191.13,1,139.69,378905,276433,102472
2076-11,237957,41686,44010,6408,93222,206410,17621,21570,2218,753,90.57,0,105.4,279643,389241,-109598
2076-12,413225,22762,32118,5871,178617,111798,21005,32582,539,1958,854.38,1,108.89,435987,381991,53996
2077-01,462069,34459,48646,12600,132449,174168,6494,14306,2004,1723,158.4,0,135.47,496528,388663,107865
2077-02,436735,35774,28204,13595,103138,245935,19623,13054,3959,1821,108.65,0,110.65,472509,423549,48960
2077-03,453835,32217,44300,8403,184632,84794,13438,35791,801,2358,492.44,1,131.15,486052,371358,114694
2077-04,108617,47463,42084,12887,174045,202184,22214,14021,939,1041,30.05,1,128.25,156080,467435,-311355
2077-05,261203,47266,37294,14676,85237,129226,26657,10100,3324,648,56.67,0,137.42,308469,303190,5279
2077-06,474737,21766,32973,7010,175219,86245,21677,5789,969,2868,498.98,0,123.58,496503,328913,167590
2077-07,452189,17980,47715,13914,121457,107748,7530,12130,4864,2240,80.97,0,136.79,470169,310494,159675
2077-08,150383,22105,48716,7029,92590,88192,27578,37056,2358,3155,152.02,1,85.16,172488,301161,-128673
2077-09,247612,41205,35133,9337,101741,249847,5393,25197,1278,1628,125.87,1,148.11,288817,426648,-137831
2077-10,339655,30061,21220,11169,131966,133872,25201,7465,1095,865,298.12,1,108.79,369716,330893,38823
2077-11,167770,39047,36875,5600,181542,148968,6083,6381,2060,3510,-3.98,0,86.89,206817,385449,-178632
2077-12,240207,34145,29347,6094,133660,186415,19449,13111,1977,2322,220.26,1,99.31,274352,388076,-113724
2078-01,173684,35715,23269,8003,132382,119527,5586,15488,1549,635,168.58,0,112.99,209399,304255,-94856
2078-02,304362,37467,42532,9172,171644,148877,9713,33966,1018,3978,368.4,0,115.94,341829,415904,-74075
2078-03,111584,39559,39685,7779,129437,235438,12922,7745,3417,1151,131.07,1,120.27,151143,433006,-281863
2078-04,494042,44955,41172,7342,129357,176285,14240,6896,4717,2726,121.84,1,136.02,538997,375292,163705
2078-05,218806,27954,32849,7464,170242,223505,17432,18796,4357,3585,63.67,0,122.89,246760,470288,-223528
2078-06,331524,42660,46037,12827,90699,190806,29001,36739,819,997,408.88,0,130.29,374184,406109,-31925
2078-07,409253,48050,37309,11194,96059,142273,16374,35607,4388,3423,75.43,0,120.48,457303,338816,118487
2078-08,158947,11371,48427,12561,133314,58970,17709,23276,2783,3842,114.34,1,120.58,170318,294257,-123939
2078-09,461584,22199,41012,13787,99210,51970,23705,7446,3094,2160,187.36,1,149.25,483783,237130,246653
2078-10,345099,49070,22300,7817,121607,86800,17917,24986,1166,2778,129.58,1,107.25,394169,281427,112742
2078-11,491402,20717,39270,13225,134512,100172,26583,23374,4384,499,28.07,0,108.43,512119,337136,174983
2078-12,418945,20788,32871,11095,126087,169816,29101,35788,3066,3973,102.95,1,83.17,439733,404758,34975
2079-01,418318,36088,45608,9043,184895,94417,19332,26026,4250,3823,104.14,0,117.57,454406,379321,75085
2079-02,332028,21602,44708,13193,119381,167471,20815,29653,1185,636,300.6,0,107.25,353630,395221,-41591
2079-03,446975,33621,29223,14422,171108,202038,20177,38301,2467,2236,124.52,1,148.09,480596,475269,5327
2079-04,227147,13181,28684,7452,92408,249786,12060,8687,2115,3140,9.88,1,97.1,240328,399077,-158749
2079-05,198483,23937,39783,12211,95658,187103,18905,24079,1170,3845,191.78,0,142.27,222420,377739,-155319
2079-06,298884,38664,28576,8209,169573,119328,13948,18449,2753,3723,145.75,0,92.88,337548,358083,-20535
2079-07,414229,33385,27100,7063,98751,117885,17648,13591,2824,1749,130.41,0,135.96,447614,282038,165576
2079-08,350811,45262,28533,14728,168448,247652,5227,21237,1805,3198,248.76,1,139.07,396073,485825,-89752
2079-09,418761,49208,32501,13434,161907,183977,22719,23274,4447,436,108.28,1,87.53,467969,437812,30157
2079-10,353799,26431,34811,7878,178004,81103,25174,19492,4963,1642,146.77,1,93.79,380230,346462,33768
2079-11,272581,39642,34795,14674,131718,178352,6264,39120,2720,3797,35.56,0,104.35,312223,404923,-92700
2079-12,397383,10455,25968,14779,183499,216565,16269,32909,4132,1698,141.77,1,108.99,407838,489989,-82151
2080-01,448387,48611,29641,11667,103665,245159,23200,13367,4903,1253,145.51,0,121.29,496998,426699,70299
2080-02,328689,49579,43169,8788,100510,127068,7209,19372,2811,1968,93.88,0,107.39,378268,306116,72152
2080-03,385471,18208,29341,10817,160146,214210,11658,33637,4335,2297,6.43,1,125.98,403679,459809,-56130
2080-04,309918,13909,28384,8643,104365,210311,7495,7926,1215,2874,202.77,1,144.69,323827,367124,-43297
2080-05,291162,48713,45661,12842,162341,107446,5715,25212,2541,648,116.11,0,88.47,339875,359217,-19342
2080-06,452707,18098,39505,5957,182697,78022,9528,27916,2188,1883,194.95,0,139.31,470805,343625,127180
2080-07,200886,28012,21277,13565,158299,100432,5101,19009,2916,1296,62.14,0,125.2,228898,317683,-88785
2080-08,188448,33082,41618,9893,107943,50475,19968,5869,4349,1733,81.72,1,113.03,221530,235766,-14236
2080-09,267222,14167,45597,13403,120924,215001,21736,20013,1525,1949,111.58,1,125.0,281389,436674,-155285
2080-10,469089,42413,36742,8373,172030,136012,10040,21209,3194,1535,223.05,1,109.62,511502,384406,127096
2080-11,478220,29849,42473,14350,104003,241617,27947,33255,2070,334,143.32,0,98.52,508069,463645,44424
2080-12,480081,16629,31143,13773,110825,233096,18609,38870,1464,627,359.47,1,85.93,496710,446316,50394
2081-01,276705,13294,32697,12229,158114,104295,20938,37082,3061,512,83.54,0,145.54,289999,365355,-75356
2081-02,238203,29078,41544,5162,84811,60564,9317,39987,4241,2955,106.38,0,86.52,267281,241385,25896
2081-03,272840,41813,33743,12274,160878,196415,21032,20643,2042,3365,59.41,1,105.42,314653,444985,-130332
2081-04,214786,18081,24117,10837,100807,106638,16393,26247,3830,2557,52.18,1,112.22,232867,285039,-52172
2081-05,329376,12260,42963,9885,96391,158166,18104,18648,3527,3706,52.65,0,101.62,341636,344157,-2521
2081-06,418382,44837,27627,5284,93675,88799,21372,22424,2007,2952,228.04,0,143.03,463219,259181,204038
2081-07,402444,28121,36068,13880,115422,66281,24179,13961,2047,3422,105.45,0,82.89,430565,269791,160774
2081-08,140362,25425,25109,12332,193754,223487,13807,37362,3647,3304,86.54,1,101.52,165787,505851,-340064
2081-09,417996,30695,24836,10110,114598,83458,22053,20030,1584,2315,328.95,1,124.09,448691,275085,173606
2081-10,283506,19273,26818,6214,107968,54668,20647,15907,1061,3213,198.64,1,81.8,302779,232222,70557
2081-11,316877,20439,22790,11498,124137,112817,11203,19878,2096,3791,151.65,0,132.11,337316,302323,34993
2081-12,181678,43858,44901,10477,150892,173736,16721,15624,3416,2999,9.28,1,127.24,225536,412351,-186815
2082-01,403254,15303,29164,14383,181712,214853,29336,30536,1525,2882,257.85,0,87.87,418557,499984,-81427
2082-02,428954,28565,25883,6920,144364,87584,17940,14229,4304,1486,14.29,0,86.34,457519,296920,160599
2082-03,455852,30436,27281,14744,116424,81703,5786,34168,1850,3401,205.3,1,149.64,486288,280106,206182
2082-04,376123,40449,35113,14825,177316,132498,12378,25205,1080,1998,431.63,1,95.75,416572,397335,19237
2082-05,109233,33679,49893,13778,194399,181073,27799,5850,860,355,36.36,0,115.4,142912,472792,-329880
2082-06,237463,27278,45472,6327,156768,155205,16269,30106,1462,2323,157.76,0,87.74,264741,410147,-145406
2082-07,376089,23719,35981,8491,182199,50951,10211,36978,2348,384,182.0,0,103.92,399808,324811,74997
2082-08,332220,46050,26949,8604,152188,201921,6460,34511,3755,490,9.44,1,109.01,378270,430633,-52363
2082-09,481654,10537,42708,8246,176853,193105,29381,34224,1862,2078,364.85,1,148.96,492191,484517,7674
2082-10,279230,26962,22144,14936,109310,178113,26899,32207,2648,3330,156.15,1,148.64,306192,383609,-77417
2082-11,415981,45037,48889,12297,80452,244443,25796,31970,1190,1958,229.48,0,86.68,461018,443847,17171
2082-12,138093,21311,23047,9836,82879,189122,14528,32011,3299,2542,3.57,1,121.42,159404,351423,-192019
2083-01,278675,49546,45490,6771,164170,147081,15125,12069,3164,3819,41.99,0,133.19,328221,390706,-62485
2083-02,266589,46417,29853,13248,153723,103963,27939,10125,3926,3486,152.08,0,147.35,313006,338851,-25845
2083-03,360174,45515,23491,14889,118990,166900,18759,10009,1077,1466,250.5,1,92.69,405689,353038,52651
2083-04,136075,33941,27323,7972,180667,188215,28858,12826,988,3071,157.25,1,127.25,170016,445861,-275845
2083-05,380424,16390,49300,10123,188964,152078,25157,15032,3353,1375,90.42,0,104.65,396814,440654,-43840
2083-06,440644,41679,38327,9889,120010,200678,19435,36850,4511,3329,19.25,0,135.06,482323,425189,57134
2083-07,200287,20315,41132,6546,129790,81508,26199,38412,1671,3724,135.74,0,123.47,220602,323587,-102985
2083-08,219767,35536,49111,5047,114177,150493,19543,23042,4662,2513,49.02,1,136.02,255303,361413,-106110
2083-09,322564,25742,41555,12228,115872,137724,28028,14438,3131,1162,78.6,1,103.29,348306,349845,-1539
2083-10,448594,36623,44349,13480,197272,207472,6231,15589,2546,2935,141.12,1,87.82,485217,484393,824
2083-11,278710,28111,42614,14238,129314,72890,28988,9728,3759,3064,135.98,0,121.9,306821,297772,9049
2083-12,111444,19495,45845,13133,177868,234209,10004,5466,1093,781,15.73,1,135.43,130939,486525,-355586
2084-01,106897,16442,32870,14918,199177,158795,24788,37273,717,2446,155.13,0,132.77,123339,467821,-344482
2084-02,449387,10964,43729,11551,155235,131457,13025,18994,4086,745,111.07,0,148.06,460351,373991,86360
2084-03,291627,17234,20370,9387,170268,164409,26816,36813,1155,1675,276.55,1,125.69,308861,428063,-119202
2084-04,238372,35056,25630,7900,173750,141922,17818,28065,2887,774,50.54,1,96.09,273428,395085,-121657
2084-05,452137,30222,28547,14832,81882,170507,16744,37099,2380,1441,130.84,0,131.86,482359,349611,132748
2084-06,228658,41790,44695,12425,184465,101078,17389,33194,3537,2235,22.72,0,97.32,270448,393246,-122798
2084-07,330280,43157,35428,7198,158372,95810,21252,38898,2304,1039,171.38,0,142.72,373437,356958,16479
2084-08,379013,25706,48646,6602,168871,86497,15872,33344,1109,2550,292.96,1,121.54,404719,359832,44887
2084-09,405556,14781,35860,13983,144763,187100,19983,31718,4055,1099,87.22,1,93.45,420337,433407,-13070
2084-10,182164,37927,38416,11920,147628,69693,15271,8197,3292,3530,51.18,1,130.44,220091,291125,-71034
2084-11,433342,31317,43572,7692,171857,146131,9812,7590,3005,720,208.0,0,146.36,464659,386654,78005
2084-12,218488,42607,32420,6899,147514,101300,8401,16725,4310,1865,15.9,1,130.27,261095,313259,-52164
2085-01,101212,46568,40465,12295,197073,126544,10388,39794,3229,3817,83.34,0,108.33,147780,426559,-278779
2085-02,444222,22770,27384,6737,127819,75392,28232,19936,812,605,613.04,0,86.33,466992,285500,181492
2085-03,136736,48199,23269,10406,103593,152505,21475,12937,4284,806,-29.49,1,87.3,184935,324185,-139250
2085-04,204359,42553,29409,14504,164608,147068,20867,39338,4399,1911,51.71,1,123.34,246912,415794,-168882
2085-05,124397,46807,35778,7152,91889,114280,24112,25897,2632,3419,55.46,0,110.98,171204,299108,-127904
2085-06,455520,44125,26043,9207,89733,97963,14718,16723,1558,683,204.74,0,87.93,499645,254387,245258
2085-07,176364,32167,46115,6096,111757,140317,12183,18736,1615,822,150.77,0,89.91,208531,335204,-126673
2085-08,128510,23611,26594,5066,122609,117325,25412,5739,598,684,214.86,1,122.23,152121,302745,-150624
2085-09,374738,43842,47276,7007,149949,134103,9771,21066,2421,3529,160.64,1,121.27,418580,369172,49408
2085-10,245440,41281,30970,11716,188144,235330,28195,30424,961,3369,200.33,1,134.28,286721,524779,-238058
2085-11,203408,47459,29565,8170,150395,212352,6100,29351,3335,1807,115.01,0,145.04,250867,435933,-185066
2085-12,229567,46844,24944,11466,84419,87667,25221,16276,1661,1138,106.04,1,104.18,276411,249993,26418
2086-01,302963,21193,26858,9851,151401,216726,24484,10583,4489,2165,57.25,0,131.56,324156,439903,-115747
2086-02,393400,14072,27226,10868,182137,199526,15284,15443,621,3354,563.34,0,84.43,407472,450484,-43012
2086-03,452254,16650,23591,11674,91778,63079,14783,16606,1411,1637,252.95,1,127.66,468904,221511,247393
2086-04,321741,30210,32301,12312,195020,189252,13487,27968,4265,2897,98.44,1,109.03,351951,470340,-118389
2086-05,129077,23724,26931,9507,110204,142041,19102,34104,740,2187,203.39,0,120.9,152801,341889,-189088
2086-06,484986,11524,48327,7544,189873,202984,12288,23973,4930,699,94.01,0,129.43,496510,484989,11521
2086-07,127441,17266,31440,9250,155799,82057,10651,34481,3606,3304,22.79,0,110.96,144707,323678,-178971
2086-08,385698,18672,42128,7403,158609,53502,28206,28689,748,1994,409.7,1,97.91,404370,318537,85833
2086-09,296700,11206,32809,9490,155630,216351,8941,29390,4235,3533,97.54,1,141.67,307906,452611,-144705
2086-10,113834,26612,27356,5362,158075,177463,6206,22172,1205,704,155.16,1,142.03,140446,396634,-256188
2086-11,279015,34152,38810,12999,113269,155530,8381,38081,4608,1566,89.14,0,142.87,313167,367070,-53903
2086-12,323455,15424,49153,8493,90666,215783,5900,18776,653,3290,460.95,1,147.01,338879,388771,-49892
2087-01,288720,39463,33538,11402,172463,166825,24486,12410,4755,1568,9.02,0,117.95,328183,421124,-92941
2087-02,102515,48662,21289,13039,98231,167864,15521,32023,4703,3678,112.95,0,99.19,151177,347967,-196790
2087-03,381957,48860,38476,9171,154818,173851,14134,6110,2773,2330,123.71,1,110.69,430817,396560,34257
2087-04,247171,20521,36066,5740,101037,217020,11001,37501,1827,664,203.73,1,119.29,267692,408365,-140673
2087-05,482419,40042,42155,11672,107852,109448,27125,11230,3853,311,116.55,0,84.32,522461,309482,212979
2087-06,493312,30341,37972,8515,149611,195244,22999,12791,4362,943,121.44,0,89.54,523653,427132,96521
2087-07,314868,28193,41292,13200,130650,106253,16156,7562,1507,831,171.92,0,111.51,343061,315113,27948
2087-08,137085,35521,29262,10264,187020,151731,14245,12549,1032,3063,215.78,1,110.88,172606,405071,-232465
2087-09,335845,20937,46563,8437,171454,89144,21832,15774,1941,749,236.27,1,144.68,356782,353204,3578
2087-10,241075,27923,32402,12380,94847,121145,18487,6431,1381,1445,144.86,1,112.21,268998,285692,-16694
2087-11,448120,46927,39275,12528,121763,203214,13450,32339,3400,2805,132.46,0,100.05,495047,422569,72478
2087-12,206858,30650,34470,11989,99510,220221,25628,30649,1910,1296,121.43,1,125.89,237508,422467,-184959
2088-01,190930,24714,33460,14696,80906,207220,7079,5442,4893,314,-20.93,0,85.23,215644,348803,-133159
2088-02,473451,47320,46898,8945,196555,153835,28339,39771,2568,935,148.1,0,146.93,520771,474343,46428
2088-03,170177,48659,43217,6712,143706,50761,22903,28928,2125,451,40.77,1,109.55,218836,296227,-77391
2088-04,367909,21729,34140,6034,169662,227380,11489,35375,2656,3548,147.02,1,83.88,389638,484080,-94442
2088-05,393859,37025,27074,7594,116630,102594,16900,23549,3296,1578,145.53,0,110.97,430884,294341,136543
2088-06,416589,42066,24545,13578,117962,213617,23788,29883,887,2325,495.34,0,102.26,458655,423373,35282
2088-07,235256,29736,23765,8561,111875,236333,28148,30111,1784,2815,93.75,0,86.89,264992,438793,-173801
2088-08,205791,34816,40666,7996,130469,206661,16381,30483,2276,1616,92.86,1,125.88,240607,432656,-192049
2088-09,140855,39565,44189,13884,87238,67811,11820,26178,1570,2784,114.09,1,103.81,180420,251120,-70700
2088-10,301489,45713,44919,5944,155857,155282,22376,28915,1762,3345,231.5,1,112.46,347202,413293,-66091
2088-11,325478,42618,20266,8668,87206,215749,5953,39205,2532,2943,120.79,0,96.65,368096,377047,-8951
2088-12,118000,22054,43118,7006,136431,190510,8541,34838,3141,1957,-11.53,1,129.16,140054,420444,-280390
2089-01,310831,12987,20969,13378,143692,172222,22324,15536,3982,1450,71.6,0,134.25,323818,388121,-64303
2089-02,236996,29374,38147,5502,169358,112867,29212,28224,4047,2041,106.97,0,102.36,266370,383310,-116940
2089-03,107518,18092,43432,12956,159576,77002,21328,17702,3400,3324,4.29,1,99.42,125610,331996,-206386
2089-04,350125,17155,42000,11325,194900,207860,22519,9711,656,3220,596.37,1,106.89,367280,488315,-121035
2089-05,457791,30646,28957,9498,157866,55398,22157,39448,4269,1947,102.45,0,96.51,488437,313324,175113
2089-06,163138,28939,23934,13018,85054,217954,18679,5705,4749,3310,119.31,0,109.38,192077,364344,-172267
2089-07,140116,42697,21392,14544,112278,133244,28890,18410,1962,2502,54.89,0,108.37,182813,328758,-145945
2089-08,228772,21659,47767,13764,189424,111465,10193,12978,1183,950,226.7,1,125.84,250431,385591,-135160
2089-09,285483,37967,27196,9121,159321,100664,20160,35269,1412,325,240.63,1,108.73,323450,351731,-28281
2089-10,469271,18955,32672,7495,177901,172892,23272,16051,1357,3759,352.79,1,101.01,488226,430283,57943
2089-11,378350,23848,45754,11779,86738,50882,9810,15015,3510,1431,-5.85,0,87.48,402198,219978,182220
2089-12,497014,24815,42467,7047,194200,50586,29991,30437,2096,1688,220.75,1,130.35,521829,354728,167101
2090-01,293994,31757,21150,6923,154206,112119,29831,5859,1654,1185,164.51,0,94.8,325751,330088,-4337
2090-02,335435,16156,23939,5560,106776,136198,25247,29736,4533,2288,160.4,0,93.92,351591,327456,24135
2090-03,383418,49837,36380,8331,184717,66563,16507,22236,3654,988,162.02,1,122.6,433255,334734,98521
2090-04,242511,41968,32906,5163,94019,219803,21120,10432,4996,2877,152.17,1,120.64,284479,383443,-98964
2090-05,364611,36106,35848,7601,96926,54665,13606,9054,1373,2073,289.1,0,129.02,400717,217700,183017
2090-06,299125,41660,32976,7230,122513,201363,11965,39481,2788,515,136.48,0,115.18,340785,415528,-74743
2090-07,282313,35613,37728,5769,169489,234329,13201,22271,2893,2111,27.71,0,122.71,317926,482787,-164861
2090-08,100508,39089,41877,6054,165019,107388,11614,9659,3908,326,90.77,1,122.91,139597,341611,-202014
2090-09,103237,14681,33667,13273,180874,209564,9396,32140,725,973,192.87,1,134.57,117918,478914,-360996
2090-10,105361,27822,23703,6012,184962,139496,10932,12510,3677,2664,46.51,1,86.73,133183,377615,-244432
2090-11,467497,17020,33400,13339,178241,186735,15124,10469,1684,3109,313.23,0,100.86,484517,437308,47209
2090-12,117889,46635,22629,13638,116978,164378,11631,30577,1021,3094,89.54,1,119.97,164524,359831,-195307
2091-01,275761,13476,42155,7865,80577,160873,18498,33059,3091,2857,34.4,0,129.46,289237,343027,-53790
2091-02,374466,14647,45194,12304,85795,214111,19293,22411,4214,1271,113.19,0,112.0,389113,399108,-9995
2091-03,467013,12623,34817,12816,135748,249279,17588,29370,4154,1117,172.47,1,110.47,479636,479618,18
2091-04,446558,40895,25888,14875,197749,132422,23934,24941,3285,651,99.83,1,142.69,487453,419809,67644
2091-05,370925,33146,26658,10827,172225,54668,19291,34471,959,783,348.96,0,100.36,404071,318140,85931
2091-06,226164,24581,37688,13366,93103,51359,20156,28189,4185,1369,71.74,0,88.25,250745,243861,6884
2091-07,143243,44776,41800,13191,93867,154870,25485,27409,1362,3736,58.49,0,112.81,188019,356622,-168603
2091-08,489256,33591,22388,14794,134854,96240,9003,18134,4258,3497,93.34,1,139.55,522847,295413,227434
2091-09,211888,11845,38671,12513,176366,187230,9097,38222,4555,2836,103.88,1,89.71,223733,462099,-238366
2091-10,121862,47448,47611,8678,129021,170519,21055,32947,4160,3926,-23.62,1,100.1,169310,409831,-240521
2091-11,134752,14731,25042,13223,98258,104766,12044,8946,3306,3884,78.27,0,103.49,149483,262279,-112796
2091-12,317042,27486,35197,6058,155578,73791,5032,22092,3388,3689,96.22,1,148.26,344528,297748,46780
2092-01,345411,32602,26214,10712,162956,156032,16523,18401,3695,2435,-11.44,0,127.67,378013,390838,-12825
2092-02,261487,45773,24375,11483,169010,102880,25532,18836,770,2785,398.99,0,126.14,307260,352116,-44856
2092-03,444311,19731,26480,6578,93345,198421,13785,26879,3317,3158,164.54,1,86.81,464042,365488,98554
2092-04,183506,38675,34976,9015,120094,84798,19786,17500,4917,2241,95.65,1,139.59,222181,286169,-63988
2092-05,214399,19188,30123,14030,156614,131017,13431,5422,2610,3688,120.68,0,124.12,233587,350637,-117050
2092-06,202249,14586,36906,9209,125541,211210,20021,32531,4608,1773,98.31,0,138.87,216835,435418,-218583
2092-07,208113,49663,20406,13153,157527,99485,17673,28840,3825,410,72.28,0,117.11,257776,337084,-79308
2092-08,254626,49777,35771,12848,108922,61956,10277,5140,1515,1755,197.97,1,107.42,304403,234914,69489
2092-09,323721,16538,26727,12973,168857,189553,22776,17736,2956,482,143.63,1,95.23,340259,438622,-98363
2092-10,433129,40976,35949,10124,143598,137799,13443,21463,1652,1385,288.57,1,148.63,474105,362376,111729
2092-11,162821,26476,28888,5178,141630,146640,17190,11479,3174,3633,-8.54,0,142.18,189297,351005,-161708
2092-12,184306,10876,30261,10654,96024,72530,29092,34245,1909,1642,40.73,1,134.56,195182,272806,-77624
2093-01,244292,20383,22901,12640,197862,70830,11335,14764,795,609,372.29,0,126.63,264675,330332,-65657
2093-02,449989,12698,41691,8989,148777,186135,14124,35598,1612,1946,250.16,0,119.98,462687,435314,27373
2093-03,290370,29234,28675,7471,185599,84745,8406,23327,3451,2308,82.33,1,133.33,319604,338223,-18619
2093-04,117680,32393,49001,14755,166923,137500,10984,20421,4084,3899,-51.84,1,104.93,150073,399584,-249511
