Month-Year,Sales Revenue (₹),Service Fees (₹),Rent (₹),Utilities (₹),Salaries & Wages (₹),Raw Materials / Inventory (₹),Transportation / Logistics (₹),Loan Repayments & Interest (₹),Number of Orders,Customers,Average Order Value,Seasonality_Flag,Fuel Price Index,Total Income (₹),Total Expenses (₹),Net Cash Flow (₹)
2010-01,197235,12369,30067,9207,130669,51029,12162,27554,850,3817,264.67,0,127.23,209604,260688,-51084
2010-02,296286,24314,47271,6646,132843,191257,9870,6773,4755,3432,118.75,0,106.81,320600,394660,-74060
2010-03,117386,40209,37084,13459,163094,74235,5735,32609,4093,1902,3.99,1,136.97,157595,326216,-168621
2010-04,423569,38472,37717,5988,153623,63189,9828,7714,4860,1207,123.98,1,132.09,462041,278059,183982
2010-05,186912,40488,34833,10586,142306,90172,14299,30128,2125,564,203.18,0,99.17,227400,322324,-94924
2010-06,303671,37947,26738,14717,95948,152211,15561,19222,4673,2847,13.68,0,118.23,341618,324397,17221
2010-07,411748,29093,30439,8902,118133,68439,21372,24889,3808,684,137.05,0,131.1,440841,272174,168667
2010-08,102208,16206,34913,9087,195143,158477,26107,37406,4472,3104,8.84,1,97.32,118414,461133,-342719
2010-09,183163,39978,43553,13473,160735,230805,17577,17907,806,1917,242.32,1,146.6,223141,484050,-260909
2010-10,463214,38547,25977,14459,135137,90458,27600,17258,4758,3606,98.29,1,120.63,501761,310889,190872
2010-11,365344,23754,31930,7755,122978,114372,6413,34149,2372,1374,135.32,0,104.99,389098,317597,71501
2010-12,145267,41585,47723,8316,101274,101301,28742,10309,4091,483,129.2,1,107.8,186852,297665,-110813
2011-01,303569,23184,38942,11325,140589,161553,26374,10651,4671,332,131.94,0,129.03,326753,389434,-62681
2011-02,247192,13728,25340,6643,169009,58440,12062,16626,3258,2314,44.39,0,105.55,260920,288120,-27200
2011-03,229816,14688,45821,13416,195098,124792,15969,14632,785,1329,270.53,1,91.25,244504,409728,-165224
2011-04,368906,24873,45490,9941,177857,235473,16713,17792,4753,2146,127.43,1,127.78,393779,503266,-109487
2011-05,126551,39747,34893,13957,176198,191340,13463,39895,1095,3397,103.38,0,137.87,166298,469746,-303448
2011-06,420997,34002,29393,12459,132229,233460,29322,31107,1838,838,225.66,0,135.57,454999,467970,-12971
2011-07,262887,41527,27067,8759,132793,203918,28717,34510,2241,2101,109.62,0,99.43,304414,435764,-131350
2011-08,314272,25258,30285,14738,136885,122424,25512,39736,3561,499,51.12,1,146.4,339530,369580,-30050
2011-09,428635,16038,39058,5015,121573,135571,6892,39526,4835,830,53.13,1,86.87,444673,347635,97038
2011-10,112348,13121,43599,7357,160798,206533,7030,29750,4841,3302,10.24,1,137.07,125469,455067,-329598
2011-11,147414,33235,41088,10583,130799,183380,14101,33441,3414,511,79.95,0,130.57,180649,413392,-232743
2011-12,269295,21436,32819,6034,106735,142435,20069,14590,4459,824,31.4,1,115.49,290731,322682,-31951
2012-01,488381,10707,26912,7014,82018,100907,26973,36814,528,521,892.77,0,98.38,499088,280638,218450
2012-02,281490,36921,38542,7949,138422,205258,24723,25944,3214,3929,55.54,0,134.42,318411,440838,-122427
2012-03,481532,16546,43259,8959,117157,141678,21040,5678,1672,3268,317.9,1,134.55,498078,337771,160307
2012-04,220702,30340,43298,14293,196228,128898,5879,18361,2003,2549,149.9,1,139.88,251042,406957,-155915
2012-05,208402,21735,38039,14203,171843,160436,28304,13226,3213,1142,40.76,0,147.36,230137,426051,-195914
2012-06,215105,13855,42342,13339,195477,63346,11144,34838,1006,699,237.78,0,85.44,228960,360486,-131526
2012-07,250610,12079,49427,7682,152371,137716,12679,38034,4421,1049,116.31,0,102.75,262689,397909,-135220
2012-08,403188,39757,41323,14871,116937,85444,11914,31292,755,3809,618.07,1,140.42,442945,301781,141164
2012-09,336477,29679,26435,5001,103757,189300,22126,6456,2388,3998,249.45,1,116.73,366156,353075,13081
2012-10,472463,18738,47859,6484,162390,216670,29141,26781,1500,3323,300.35,1,95.79,491201,489325,1876
2012-11,490578,42847,23300,12058,160928,197486,28948,35993,2390,3723,188.5,0,135.34,533425,458713,74712
2012-12,395324,46375,23223,7542,192940,162778,21499,15500,825,1772,581.83,1,139.72,441699,423482,18217
2013-01,314919,38509,36110,10347,86665,171852,11829,12664,2705,3234,146.11,0,144.61,353428,329467,23961
2013-02,476746,27437,44494,13612,92472,209282,19582,27010,4643,1579,100.51,0,130.81,504183,406452,97731
2013-03,376514,45787,46187,14413,150375,244552,18003,21450,2584,2052,111.64,1,113.02,422301,494980,-72679
2013-04,343832,45142,37700,12526,195590,73516,15424,10063,4584,2329,35.96,1,132.87,388974,344819,44155
2013-05,162000,20127,38551,11261,180683,144040,13663,34074,1671,1298,108.1,0,118.28,182127,422272,-240145
2013-06,251416,11768,33916,7408,179508,106514,27921,31519,4003,3766,76.63,0,89.14,263184,386786,-123602
2013-07,211204,13826,24884,5750,199665,83370,5565,7020,3984,2263,52.26,0,118.38,225030,326254,-101224
2013-08,414546,34711,42795,7540,144251,66832,9670,9051,4129,545,95.13,1,136.28,449257,280139,169118
2013-09,173836,43086,43280,10558,124934,157974,17389,25526,1384,631,142.38,1,146.17,216922,379661,-162739
2013-10,135385,11178,36495,11192,199843,163768,8020,28836,2536,3088,-36.16,1,111.1,146563,448154,-301591
2013-11,187468,42777,26642,11537,126559,216859,14109,31772,1575,1057,86.15,0,138.78,230245,427478,-197233
2013-12,336128,23175,39518,14839,160250,172040,21388,30221,1972,2900,129.25,1,120.95,359303,438256,-78953
2014-01,329396,39744,29383,10350,113085,223066,7909,39078,4443,650,89.39,0,144.4,369140,422871,-53731
2014-02,183420,44372,21353,11190,180690,64311,7051,13272,4433,372,13.97,0,115.99,227792,297867,-70075
2014-03,365472,31551,45240,9033,97399,104141,13372,30290,2617,2014,136.96,1,96.84,397023,299475,97548
2014-04,434868,36568,28134,8924,82855,168683,20510,30856,2497,483,165.48,1,148.84,471436,339962,131474
2014-05,314509,25109,29035,12573,125260,197234,10714,19958,4730,2067,55.74,0,101.75,339618,394774,-55156
2014-06,350306,44176,38464,7034,168866,216850,25698,34026,1668,1756,306.22,0,93.58,394482,490938,-96456
2014-07,408731,24651,47014,11440,138706,79529,7540,8066,3444,1792,102.87,0,84.6,433382,292295,141087
2014-08,377929,39865,38757,9296,80309,167087,24446,22925,4438,1110,143.71,1,111.88,417794,342820,74974
2014-09,439301,44831,43792,6374,142098,64568,22606,39983,2830,2637,152.53,1,91.2,484132,319421,164711
2014-10,174445,48148,28852,11496,169539,187579,15115,29030,2284,615,95.46,1,105.37,222593,441611,-219018
2014-11,433880,43741,22123,13310,163776,142767,28820,12841,3450,2390,173.31,0,135.62,477621,383637,93984
2014-12,349302,35705,42882,8418,181574,143263,9781,39886,4300,1814,188.04,1,120.43,385007,425804,-40797
2015-01,290307,33331,49295,7023,120561,201676,16056,7946,4387,3207,40.32,0,105.77,323638,402557,-78919
2015-02,242047,46100,33711,7070,195224,59217,10067,18259,4860,2427,19.39,0,100.66,288147,323548,-35401
2015-03,417840,25640,23031,6588,136715,185234,20588,13138,4778,1095,126.44,1,83.0,443480,385294,58186
2015-04,499364,24879,28518,14624,153927,76105,6961,38672,1516,1462,326.94,1,106.52,524243,318807,205436
2015-05,270119,33757,49781,6515,141325,97208,5919,27941,4578,421,43.01,0,86.23,303876,328689,-24813
2015-06,497288,16003,49793,9410,92410,91846,5833,35828,2287,2614,170.15,0,99.65,513291,285120,228171
2015-07,317719,26879,25245,12082,130918,243931,26781,6547,4168,2432,80.74,0,93.1,344598,445504,-100906
2015-08,223812,47799,45292,13544,147100,157138,20680,27710,1049,3801,181.51,1,92.2,271611,411464,-139853
2015-09,247151,19191,44239,5904,137057,167022,6830,12696,3806,355,87.04,1,146.21,266342,373748,-107406
2015-10,171845,12300,25441,13716,126533,221583,26514,37913,4544,2316,72.82,1,149.97,184145,451700,-267555
2015-11,490997,44870,34111,7900,179838,164791,10347,23973,4263,1706,117.81,0,129.1,535867,420960,114907
2015-12,368040,45663,23217,13930,177062,75904,18263,14529,1938,2731,151.13,1,83.46,413703,322905,90798
2016-01,114403,22151,42277,14956,104693,173731,12446,8665,4430,2766,-37.57,0,111.32,136554,356768,-220214
2016-02,110610,15923,47186,8797,133598,187452,25896,10539,2329,2980,47.51,0,115.27,126533,413468,-286935
2016-03,459722,40898,38809,8851,115907,156231,28703,32324,3001,3613,125.97,1,128.87,500620,380825,119795
2016-04,415812,41476,36268,14956,142802,112988,16030,16162,944,2077,453.27,1,125.21,457288,339206,118082
2016-05,252186,45822,28836,9842,129027,103377,11372,12190,4345,971,13.03,0,92.47,298008,294644,3364
2016-06,451941,12626,30872,7063,147674,88912,27118,37954,4647,384,80.57,0,85.53,464567,339593,124974
2016-07,468271,13728,34580,8430,85162,246432,28882,36559,3438,3954,147.78,0,116.98,481999,440045,41954
2016-08,186269,49183,35567,12241,104989,75936,15756,9958,1559,1036,122.82,1,105.75,235452,254447,-18995
2016-09,360434,19197,34527,12912,194733,61188,23011,14587,2864,3201,84.4,1,131.63,379631,340958,38673
2016-10,319430,29976,27282,9261,140052,181568,27248,28177,3567,3449,74.73,1,114.73,349406,413588,-64182
2016-11,423519,32260,44938,7497,180379,235537,6476,25343,3715,1705,159.13,0,145.05,455779,500170,-44391
2016-12,277948,47297,23206,7895,128080,224524,19403,26243,1956,3726,175.3,1,96.37,325245,429351,-104106
2017-01,296561,44166,49549,13064,195742,107712,29356,32201,3831,3244,-29.96,0,88.69,340727,427624,-86897
2017-02,432946,12374,20098,10697,136144,97288,12064,12246,1447,3966,271.95,0,139.79,445320,288537,156783
2017-03,315829,12735,26668,11721,116711,138410,5425,11210,2061,2366,172.86,1,92.16,328564,310145,18419
2017-04,447184,39318,35375,7954,149736,181266,12470,26145,4197,1006,57.73,1,130.61,486502,412946,73556
2017-05,382162,15574,40649,6645,112682,76474,25197,21918,1744,1242,256.96,0,137.18,397736,283565,114171
2017-06,243691,23584,27033,5994,118190,221963,6414,15009,3193,2167,14.92,0,148.25,267275,394603,-127328
2017-07,177276,20104,24272,12332,91929,63796,9833,18858,4079,2915,24.52,0,96.14,197380,221020,-23640
2017-08,276790,30927,23073,12169,177239,90146,20434,28129,1676,3026,106.13,1,145.63,307717,351190,-43473
2017-09,441524,27577,24762,8945,181977,53630,14728,7227,811,1223,558.07,1,83.54,469101,291269,177832
2017-10,226833,48181,36391,11102,168492,83996,10011,14862,4849,2856,55.02,1,132.51,275014,324854,-49840
2017-11,106448,26655,44956,5736,185860,214555,26112,37650,4574,1254,20.42,0,100.18,133103,514869,-381766
2017-12,441374,29649,49291,7678,134206,72415,18264,30307,1897,1275,318.27,1,111.51,471023,312161,158862
2018-01,389962,15782,24294,10602,160486,193533,19366,13596,2512,3496,9.75,0,145.15,405744,421877,-16133
2018-02,171244,23832,27034,8504,195657,112642,6362,23179,2443,2319,69.53,0,132.45,195076,373378,-178302
2018-03,337594,14594,36371,10783,151151,220592,16824,18481,2705,1764,188.06,1,81.99,352188,454202,-102014
2018-04,123118,37235,34572,9165,136287,72511,21859,7143,3911,997,-25.59,1,116.41,160353,281537,-121184
2018-05,385502,13435,34717,13480,128137,107196,19096,25704,3459,1566,59.5,0,147.86,398937,328330,70607
2018-06,260797,13891,24674,5441,124449,67363,15719,31735,3299,840,75.28,0,102.14,274688,269381,5307
2018-07,303859,22539,31825,8755,164085,135259,17129,36873,3663,1105,120.91,0,82.41,326398,393926,-67528
2018-08,122352,42223,21726,13325,89907,109847,20525,28557,2106,1384,19.69,1,142.48,164575,283887,-119312
2018-09,216873,33679,49736,5398,109959,84752,7666,5446,2712,3260,67.3,1,81.56,250552,262957,-12405
2018-10,459640,11126,26760,13471,90879,63078,24154,11228,3001,816,159.22,1,116.04,470766,229570,241196
2018-11,308964,22874,28107,13280,163192,68114,18867,20578,3352,363,13.44,0,129.81,331838,312138,19700
2018-12,274717,10048,30731,12443,171141,168890,6965,37534,4975,2390,18.12,1,117.29,284765,427704,-142939
2019-01,160696,21337,23862,13781,193992,95771,25958,14861,1275,338,138.04,0,91.26,182033,368225,-186192
2019-02,135561,31651,40083,14984,195532,68487,18206,28167,4130,3325,-42.97,0,117.36,167212,365459,-198247
2019-03,307732,31252,24649,13613,97740,244324,12685,24140,1929,1754,161.47,1,110.22,338984,417151,-78167
2019-04,289480,14721,44716,9161,108121,189383,13216,32061,1229,987,189.08,1,128.62,304201,396658,-92457
2019-05,491633,24617,20748,7119,87629,102495,25063,38699,3951,2159,75.91,0,108.65,516250,281753,234497
2019-06,448954,49019,29785,7760,120379,123961,24990,27882,2309,2650,209.5,0,148.49,497973,334757,163216
2019-07,338561,10107,27483,14891,159919,82812,9389,8166,4999,3878,32.86,0,106.94,348668,302660,46008
2019-08,113059,29166,23767,13588,88491,69123,21247,38410,542,2565,222.92,1,94.95,142225,254626,-112401
2019-09,112263,28125,29687,11499,93250,109839,24545,23476,4497,2335,73.5,1,141.24,140388,292296,-151908
2019-10,364614,34906,34272,7602,172358,212719,5210,29273,1489,2062,285.28,1,96.51,399520,461434,-61914
2019-11,316738,39873,22906,6515,190321,209964,23485,30029,2090,2059,98.13,0,145.93,356611,483220,-126609
2019-12,191843,39752,47096,9877,174875,216159,13865,36470,730,2039,228.75,1,85.54,231595,498342,-266747
2020-01,375412,41658,27396,10782,144415,113064,13435,24022,2363,1847,194.7,0,113.52,417070,333114,83956
2020-02,326558,19343,33991,6989,181415,59541,15450,37670,1417,1869,280.98,0,118.74,345901,335056,10845
2020-03,348168,30272,48516,14845,182735,90486,11294,10171,2530,1110,134.61,1,81.02,378440,358047,20393
2020-04,438670,43211,25793,6866,89859,94576,28292,22538,2296,2103,245.88,1,110.46,481881,267924,213957
2020-05,401688,47366,30480,10438,174105,104500,14620,6134,2630,2510,121.55,0,87.94,449054,340277,108777
2020-06,403234,40659,36574,6563,132011,181561,27952,8170,3231,3413,112.17,0,85.91,443893,392831,51062
2020-07,136331,23959,30610,7569,83306,188978,22235,9101,2868,301,29.28,0,100.21,160290,341799,-181509
2020-08,198838,24101,34143,10798,95379,144313,28381,32656,3858,2348,127.46,1,91.24,222939,345670,-122731
2020-09,273476,21659,40453,13509,95799,148796,19940,24444,2514,3969,10.19,1,106.56,295135,342941,-47806
2020-10,271560,10276,40802,10698,143792,161863,13363,28835,3749,821,77.99,1,101.26,281836,399353,-117517
2020-11,280161,16966,22317,9040,191813,123095,14723,30034,631,3138,565.47,0,108.17,297127,391022,-93895
2020-12,168535,32198,23345,12793,106399,111734,5933,26500,1825,504,81.7,1,145.51,200733,286704,-85971
2021-01,320595,21141,23681,10509,170009,56069,10074,35139,4656,3325,124.54,0,141.24,341736,305481,36255
2021-02,277273,12512,35617,13131,132914,70826,27631,26988,1034,1467,327.56,0,89.25,289785,307107,-17322
2021-03,283569,35992,48279,14436,90907,73197,7260,23159,4644,1079,59.7,1,134.6,319561,257238,62323
2021-04,134730,26758,40923,14149,126170,240276,6798,20046,2027,3895,41.62,1,118.39,161488,448362,-286874
2021-05,229274,26930,21298,7456,114042,199603,23088,38755,2561,2801,92.9,0,124.82,256204,404242,-148038
2021-06,374519,10144,44593,5847,112889,172889,7901,36424,2118,572,250.98,0,106.44,384663,380543,4120
2021-07,388296,38919,40589,5481,129267,57004,5336,26265,4430,2312,13.94,0,84.67,427215,263942,163273
2021-08,191548,42713,44079,10625,80274,128729,17429,15509,1810,2831,124.26,1,140.33,234261,296645,-62384
2021-09,373525,46335,32435,6942,89094,76046,21104,10226,1091,3924,458.62,1,137.13,419860,235847,184013
2021-10,377655,14708,27731,13137,140190,159263,28512,14699,2097,2671,85.87,1,97.81,392363,383532,8831
2021-11,229251,10122,37385,9805,148454,159286,21223,37048,2222,3684,114.32,0,92.8,239373,413201,-173828
2021-12,323514,17426,32446,8045,98699,122815,24478,13766,1070,1146,344.62,1,138.91,340940,300249,40691
2022-01,383200,30247,35121,7518,161342,59665,9276,13075,2278,712,131.38,0,139.01,413447,285997,127450
2022-02,448221,34191,37059,5362,172598,190272,24327,10471,1052,1780,428.51,0,112.9,482412,440089,42323
2022-03,328335,29031,26550,11418,125276,102205,27439,20912,3496,3159,125.14,1,136.04,357366,313800,43566
2022-04,327052,44088,37755,10682,161810,215133,5346,22170,3076,499,20.94,1,126.27,371140,452896,-81756
2022-05,278950,18678,33342,8266,167138,90264,16372,27441,3548,3249,74.95,0,148.24,297628,342823,-45195
2022-06,397295,43622,40984,12511,122330,151774,26819,10374,4598,1935,115.0,0,98.94,440917,364792,76125
2022-07,326267,42118,49573,11757,134492,69606,25972,11611,4433,2804,130.75,0,106.96,368385,303011,65374
2022-08,259186,38903,23455,9176,175194,186392,11168,11850,3713,2294,7.16,1,106.63,298089,417235,-119146
2022-09,478866,48335,48675,10252,164361,96093,8700,6537,3676,799,114.56,1,111.44,527201,334618,192583
2022-10,431937,26615,36272,14554,161845,119764,26478,25021,4993,2172,87.9,1,143.1,458552,383934,74618
2022-11,125079,45353,36306,9687,102690,91637,13548,29963,4912,3244,63.78,0,86.36,170432,283831,-113399
2022-12,140353,19023,26522,11768,109600,102147,9433,28169,1982,1755,78.14,1,115.96,159376,287639,-128263
2023-01,287257,39670,42087,11454,94530,164922,12844,36109,3550,3743,68.03,0,138.46,326927,361946,-35019
2023-02,157142,31028,29799,11062,162659,243327,11556,33409,658,3968,163.5,0,136.83,188170,491812,-303642
2023-03,149388,32020,23325,5900,167884,176731,9825,36673,2614,3795,57.83,1,101.27,181408,420338,-238930
2023-04,475579,41420,34787,9663,103565,115063,10993,25847,1718,816,311.23,1,146.13,516999,299918,217081
2023-05,143728,43546,34937,13298,194649,244904,21752,13974,4429,2090,40.9,0,107.04,187274,523514,-336240
2023-06,334971,31468,36685,10470,182393,191198,20332,19306,1203,1479,275.75,0,127.49,366439,460384,-93945
2023-07,456645,41483,21642,7300,194493,227310,10113,18971,2804,1031,172.21,0,126.83,498128,479829,18299
2023-08,148054,42284,41742,9517,147161,193671,8848,12517,4352,2686,123.72,1,120.75,190338,413456,-223118
2023-09,488109,22321,20557,8309,142370,103140,22897,38329,869,1415,629.45,1,81.0,510430,335602,174828
2023-10,216430,30487,44084,5889,190080,231404,12853,15008,4631,2727,103.19,1,130.16,246917,499318,-252401
2023-11,344112,35507,27521,5478,134748,56038,23694,30201,2518,3148,214.4,0,113.67,379619,277680,101939
2023-12,267097,48467,33893,9608,167848,188421,26267,22445,1249,3625,210.16,1,81.74,315564,448482,-132918
2024-01,302407,20391,29010,8108,197168,109551,8963,16364,1316,1745,149.7,0,80.41,322798,369164,-46366
2024-02,113373,24075,27611,11305,103387,84039,15318,29436,814,3681,105.79,0,96.32,137448,271096,-133648
2024-03,255993,37712,28848,9865,124368,193083,27942,38673,608,2112,380.8,1,140.36,293705,422779,-129074
2024-04,196651,23191,46896,13582,132931,65768,15435,31199,4856,2829,129.51,1,80.48,219842,305811,-85969
2024-05,397468,30432,41155,7920,91023,191670,20112,24786,4320,1500,50.83,0,129.66,427900,376666,51234
2024-06,374382,21241,47517,12749,99209,188431,24602,35885,2368,1638,180.98,0,148.23,395623,408393,-12770
2024-07,347500,18683,38371,6029,169758,193889,24954,17207,3456,661,118.31,0,86.63,366183,450208,-84025
2024-08,130076,24579,26134,9927,156085,179180,25548,18059,764,2247,185.13,1,114.37,154655,414933,-260278
2024-09,280759,32321,40241,14902,195282,166593,18372,7898,3223,2978,20.87,1,131.73,313080,443288,-130208
2024-10,386816,29214,26354,10239,162815,224965,13328,5332,1985,1868,146.42,1,107.09,416030,443033,-27003
2024-11,165264,15307,47041,13445,167972,194033,20991,30116,2205,1412,47.48,0,146.21,180571,473598,-293027
2024-12,386557,33771,30652,6806,94751,207794,25374,26167,4348,447,98.44,1,105.57,420328,391544,28784
2025-01,182241,47928,24534,6055,195489,173879,23814,32903,3208,3258,44.55,0,98.39,230169,456674,-226505
2025-02,444255,45379,26458,8601,125557,117178,21254,14811,4026,547,87.53,0,111.83,489634,313859,175775
2025-03,286646,23994,33234,10449,157760,245097,29734,36726,3172,635,149.01,1,126.31,310640,513000,-202360
2025-04,443741,20590,25304,7276,179540,86460,14896,18659,1492,461,310.39,1,92.2,464331,332135,132196
2025-05,236586,36712,26491,9267,194707,226761,22019,36653,2715,3423,145.42,0,149.65,273298,515898,-242600
2025-06,240840,33863,44273,10394,125207,100439,5867,31935,4672,443,115.23,0,99.2,274703,318115,-43412
2025-07,478429,48874,49887,7547,103947,87470,26482,5319,2543,1818,93.62,0,114.84,527303,280652,246651
2025-08,340466,27076,29742,14896,122171,136911,14329,28681,4449,407,119.99,1,110.22,367542,346730,20812
2025-09,246708,32571,38599,9251,180969,126242,5145,7126,3499,538,77.66,1,86.77,279279,367332,-88053
2025-10,227077,31766,28653,5164,89219,90253,15043,14999,1037,970,147.67,1,127.16,258843,243331,15512
2025-11,347079,13302,45075,14426,146156,239531,17249,29259,2327,1501,128.1,0,98.06,360381,491696,-131315
2025-12,446181,40507,46280,14783,191812,150094,15304,18486,2676,2091,104.39,1,116.26,486688,436759,49929
2026-01,491744,44062,27058,12188,144454,121556,13874,14899,4397,3055,63.93,0,120.62,535806,334029,201777
2026-02,172679,28751,38173,5577,169905,173148,22699,24984,3178,1579,64.24,0,126.57,201430,434486,-233056
2026-03,164255,49916,30197,8624,85985,106037,23664,35873,3974,578,54.45,1,121.47,214171,290380,-76209
2026-04,388032,37183,28455,8956,186629,198915,15537,18055,2493,2637,197.87,1,112.94,425215,456547,-31332
2026-05,391629,13706,33376,5929,111835,249571,12261,6937,4323,1343,74.66,0,127.96,405335,419909,-14574
2026-06,197382,33020,23068,6000,194346,177389,12503,35041,932,1050,198.93,0,82.03,230402,448347,-217945
2026-07,131755,41489,24462,14439,148432,202913,11949,15739,3010,3238,93.76,0,132.81,173244,417934,-244690
2026-08,440074,45032,48003,7679,192054,112113,19601,34866,3031,3556,104.88,1,132.81,485106,414316,70790
2026-09,480532,23814,41503,13721,111809,248280,15392,18100,2141,1564,204.83,1,91.38,504346,448805,55541
2026-10,120455,29157,33173,7422,105191,227318,14570,22352,4151,3741,163.03,1,100.72,149612,410026,-260414
2026-11,435211,45678,43053,10605,99958,64934,11731,27437,603,1942,708.76,0,96.47,480889,257718,223171
2026-12,496349,36252,37016,13131,178030,229519,7271,39999,608,2405,882.69,1,125.18,532601,504966,27635
2027-01,154807,13119,47674,9278,166937,238831,26657,28290,2422,314,28.61,0,128.67,167926,517667,-349741
2027-02,444886,41698,37282,8347,93465,188947,21750,37110,4657,2889,70.2,0,136.98,486584,386901,99683
2027-03,465741,30620,22205,6647,123000,198438,29142,17525,2147,601,215.13,1,83.06,496361,396957,99404
2027-04,323748,47291,29973,10712,111784,156277,12752,29284,1039,3804,371.77,1,140.44,371039,350782,20257
2027-05,168134,42476,26179,13808,87545,160345,19731,33764,4028,2029,-20.76,0,117.04,210610,341372,-130762
2027-06,400719,11950,22950,8398,186685,100708,24961,26870,3126,3155,170.0,0,105.77,412669,370572,42097
2027-07,345738,26787,38943,5567,109390,153349,10173,7787,4861,455,63.06,0,148.96,372525,325209,47316
2027-08,154065,38199,43902,12339,99179,240058,28031,22744,2424,464,-10.25,1,94.29,192264,446253,-253989
2027-09,250949,40206,38291,13691,185456,73250,27902,13886,895,1815,312.59,1,137.33,291155,352476,-61321
2027-10,109779,12248,25942,6179,132824,56380,23835,35341,2527,3707,35.0,1,107.55,122027,280501,-158474
2027-11,246203,28458,49377,12901,151454,69564,6473,21391,1353,3472,199.5,0,97.31,274661,311160,-36499
2027-12,452596,10473,24982,12600,125664,179539,16657,39008,4993,881,141.3,1,114.36,463069,398450,64619
2028-01,245580,35630,30811,10346,159051,142882,21252,36381,1251,2772,289.21,0,137.63,281210,400723,-119513
2028-02,137284,29156,45756,10298,196351,63397,9995,32836,2018,409,166.9,0,111.39,166440,358633,-192193
2028-03,366862,19442,43559,10539,140907,168591,7292,17967,3508,2486,15.48,1,81.2,386304,388855,-2551
2028-04,257479,23978,45589,9487,116665,204225,22231,27652,3064,886,88.83,1,96.9,281457,425849,-144392
2028-05,344803,20508,21041,12054,138120,176897,17898,6208,3189,3752,86.0,0,136.01,365311,372218,-6907
2028-06,354656,18656,30585,6286,137363,76532,15669,10020,4368,458,113.6,0,130.47,373312,276455,96857
2028-07,418528,24588,33162,8898,125514,229914,27597,31619,525,2277,842.05,0,146.4,443116,456704,-13588
2028-08,327101,45516,41577,13887,152056,229848,9615,33898,2316,3305,117.8,1,124.27,372617,480881,-108264
2028-09,189003,11650,44216,14642,179400,210960,14147,25027,2189,376,116.74,1,86.43,200653,488392,-287739
2028-10,461723,11321,48387,10462,96837,220615,9152,13321,942,987,504.3,1,112.82,473044,398774,74270
2028-11,304290,17921,27514,5274,83859,184848,11347,7171,4754,1021,16.17,0,112.47,322211,320013,2198
2028-12,114044,13817,38191,10655,174460,225328,14002,30745,654,1459,210.84,1,132.3,127861,493381,-365520
2029-01,292240,31592,34790,9700,187043,123061,10105,18928,2469,2710,203.2,0,97.8,323832,383627,-59795
2029-02,323002,42967,29441,6954,119312,150308,17105,14628,715,2414,351.76,0,125.61,365969,337748,28221
2029-03,470202,38607,29709,9945,133283,114925,28492,29320,1244,2708,369.36,1,139.53,508809,345674,163135
2029-04,283571,35200,47596,13836,146987,159959,15989,9661,4434,3638,76.01,1,93.55,318771,394028,-75257
2029-05,145748,45581,37366,5245,150356,139278,28447,25677,3853,711,38.67,0,83.13,191329,386369,-195040
2029-06,325841,37061,46278,13853,88560,174279,15912,23392,1536,2289,319.88,0,108.56,362902,362274,628
2029-07,315463,34181,29798,6157,153564,144998,29162,13414,2509,2173,156.58,0,82.4,349644,377093,-27449
2029-08,421413,19184,38229,10257,189918,170419,15640,21529,3844,744,84.88,1,94.07,440597,445992,-5395
2029-09,173912,11727,26734,13859,126670,175165,18707,25770,3334,1036,118.38,1,95.93,185639,386905,-201266
2029-10,340684,42525,20525,13586,104212,214957,10123,32960,4439,1558,140.7,1,87.14,383209,396363,-13154
2029-11,474492,29558,43479,8771,127990,68071,5753,32688,2061,1051,213.18,0,86.23,504050,286752,217298
2029-12,266613,25657,30922,14099,95072,248120,5500,32128,3775,3650,34.04,1,83.5,292270,425841,-133571
2030-01,380945,23580,20420,14462,177218,122669,24626,37643,1669,1569,229.67,0,80.34,404525,397038,7487
2030-02,183782,28091,20511,11789,135638,58810,20674,26272,3982,2907,53.67,0,83.82,211873,273694,-61821
2030-03,490593,30354,36205,5901,105614,176246,27919,32017,1168,3896,323.8,1,113.21,520947,383902,137045
2030-04,227119,42443,47938,9466,181269,134183,14083,30965,3539,2191,46.14,1,93.43,269562,417904,-148342
2030-05,140699,12068,22621,11073,114032,214700,12264,11296,3601,1383,72.74,0,114.81,152767,385986,-233219
2030-06,403492,23759,23994,11771,105405,138869,8670,14938,3732,1830,42.45,0,95.53,427251,303647,123604
2030-07,110308,19348,29521,8570,183591,184504,11598,27349,2974,757,21.69,0,101.69,129656,445133,-315477
2030-08,478004,20205,32510,5959,192847,118310,8214,19924,4505,3671,199.18,1,125.22,498209,377764,120445
2030-09,481836,48271,22859,6615,119036,60205,22969,30893,1862,3241,349.1,1,145.74,530107,262577,267530
2030-10,207443,30180,36513,8334,105735,161252,11724,16504,2073,1243,113.89,1,100.06,237623,340062,-102439
2030-11,200110,34428,26782,12401,136167,53038,26075,5413,1622,3393,156.62,0,83.54,234538,259876,-25338
2030-12,465276,15644,41119,12071,190619,114613,13133,38737,4350,1794,206.14,1,104.81,480920,410292,70628
2031-01,277039,46629,38054,14844,178041,156658,27505,10795,644,3109,314.62,0,131.01,323668,425897,-102229
2031-02,112353,21698,26223,10409,165961,233015,18953,7874,4155,542,-28.28,0,120.03,134051,462435,-328384
2031-03,396240,34650,20288,5068,122287,190541,10407,14709,3570,1089,161.98,1,122.21,430890,363300,67590
2031-04,277943,46200,45394,14509,107722,107955,6515,11727,1381,3444,152.34,1,119.35,324143,293822,30321
2031-05,263437,44621,47543,5501,122713,178310,20536,9511,3731,1213,156.7,0,135.13,308058,384114,-76056
2031-06,291618,41435,49114,5390,189242,117815,12708,11773,2703,2684,118.93,0,123.5,333053,386042,-52989
2031-07,350989,20018,25418,5904,123763,73102,24406,30457,1071,2063,273.01,0,113.58,371007,283050,87957
2031-08,409248,12908,39333,10478,103274,68922,27654,35988,4746,3423,-0.81,1,137.93,422156,285649,136507
2031-09,175382,44963,37374,14735,124907,161342,22360,35945,4395,1724,57.65,1,144.2,220345,396663,-176318
2031-10,191635,19184,37487,6141,170677,237853,25660,23437,3760,3530,82.8,1,129.7,210819,501255,-290436
2031-11,329332,37518,24692,10933,183868,224188,20675,23188,3368,3830,128.42,0,109.88,366850,487544,-120694
2031-12,308392,34002,31837,5374,118201,208894,13746,25774,4459,334,58.59,1,121.29,342394,403826,-61432
2032-01,131014,20655,49167,8188,136030,116109,17786,36924,1557,3907,105.6,0,93.09,151669,364204,-212535
2032-02,448619,37703,30573,10455,150523,145183,24904,6089,3179,3845,185.41,0,85.26,486322,367727,118595
2032-03,367827,15194,42889,13455,99184,133729,28314,5273,2647,3698,143.02,1,116.3,383021,322844,60177
2032-04,476975,42837,45316,6692,156767,235168,28604,21436,4932,1652,40.85,1,112.35,519812,493983,25829
2032-05,180327,30762,21603,13601,195042,187975,13567,34532,627,2690,302.29,0,99.42,211089,466320,-255231
2032-06,491440,35156,36646,9181,108284,231043,19532,15260,2272,1673,215.94,0,122.98,526596,419946,106650
2032-07,148098,20604,28482,13749,191993,64947,19083,22752,525,604,233.47,0,136.74,168702,341006,-172304
2032-08,191160,46768,46580,8548,124049,189935,17472,13918,4874,600,-4.19,1,80.5,237928,400502,-162574
2032-09,170068,12314,27218,11367,141122,243259,22033,30396,2600,761,87.72,1,107.77,182382,475395,-293013
2032-10,336553,13707,37560,11211,104762,77827,16298,38528,3656,2457,115.92,1,107.2,350260,286186,64074
2032-11,407420,22528,32153,5471,106189,73703,22521,23301,3461,2553,106.51,0,123.23,429948,263338,166610
2032-12,226685,32025,23998,6734,88232,112358,9832,9700,4847,3026,-52.25,1,121.49,258710,250854,7856
2033-01,176785,34541,31035,13740,107422,148124,27124,23387,4944,606,29.4,0,96.84,211326,350832,-139506
2033-02,340923,30721,47190,12915,191937,105178,22086,17503,4383,1163,88.98,0,96.38,371644,396809,-25165
2033-03,472057,49818,21068,8338,187360,220667,9612,38057,4327,3146,127.57,1,116.77,521875,485102,36773
2033-04,220653,46500,43100,10880,188639,55674,17890,12818,1539,1529,157.08,1,128.93,267153,329001,-61848
2033-05,449479,44363,40143,7334,184338,225584,24727,29770,507,2814,852.07,0,120.51,493842,511896,-18054
2033-06,494319,32391,37141,12121,130236,116117,27412,32171,2831,1564,213.94,0,111.86,526710,355198,171512
2033-07,441396,13063,49448,12117,116718,153523,23429,23155,3030,652,167.22,0,92.26,454459,378390,76069
2033-08,251887,20703,21194,11970,199640,125770,29883,39411,3803,2964,51.8,1,97.0,272590,427868,-155278
2033-09,480913,23845,42874,12808,116127,144617,7830,25308,4799,684,129.44,1,90.77,504758,349564,155194
2033-10,437671,28880,34191,5065,195233,122975,5842,19188,2563,999,150.49,1,135.97,466551,382494,84057
2033-11,392494,10488,31050,11035,103561,117292,16573,11822,4361,444,-15.82,0,132.04,402982,291333,111649
2033-12,284982,42889,37353,12943,85212,73755,11135,26107,1059,2163,267.13,1,123.88,327871,246505,81366
2034-01,436430,24741,30343,5715,88316,193362,12887,19053,3740,2464,157.13,0,80.49,461171,349676,111495
2034-02,319304,46964,43640,9384,145336,145588,10783,33335,1731,1743,115.3,0,142.96,366268,388066,-21798
2034-03,158763,36911,39836,5695,151088,62941,11556,37254,3382,1062,49.1,1,83.94,195674,308370,-112696
2034-04,497014,21932,38910,10228,154732,95171,13523,29424,3246,502,199.48,1,86.38,518946,341988,176958
2034-05,436688,37020,29745,7257,119865,118320,14735,18893,1502,3285,278.29,0,133.81,473708,308815,164893
2034-06,389917,17970,22159,7683,176155,84958,20587,26390,2331,2749,185.35,0,109.09,407887,337932,69955
2034-07,336683,12416,23957,7932,81934,107518,9544,27152,3820,3782,39.55,0,148.96,349099,258037,91062
2034-08,126280,32150,34127,6565,138439,183953,23415,32304,3378,1141,56.31,1,110.4,158430,418803,-260373
2034-09,353653,13235,42858,13231,128158,60946,15552,38824,2415,1995,233.23,1,98.04,366888,299569,67319
2034-10,432089,42524,29147,6166,97553,162032,28602,7027,4408,331,123.17,1,102.04,474613,330527,144086
2034-11,357540,41562,21460,8616,127336,222484,16199,34943,1491,3468,281.94,0,134.16,399102,431038,-31936
2034-12,102300,28370,33137,8060,142588,90261,13290,18999,4970,993,65.17,1,111.74,130670,306335,-175665
2035-01,136355,10110,31724,10371,84876,60229,9009,17745,1907,939,120.84,0,106.06,146465,213954,-67489
2035-02,457132,19177,26318,10641,142506,149917,5245,20131,2195,1446,234.83,0,83.33,476309,354758,121551
2035-03,457670,16453,35936,8689,97126,192658,9562,31486,4686,3547,71.2,1,117.5,474123,375457,98666
2035-04,290169,39666,20768,5251,102353,235682,9727,39014,1181,2076,225.2,1,112.11,329835,412795,-82960
2035-05,160791,13255,33014,11337,83230,249410,15772,17253,954,383,147.53,0,112.14,174046,410016,-235970
2035-06,215453,37242,45983,13848,129484,217485,13862,21788,2808,1777,124.93,0,95.06,252695,442450,-189755
2035-07,179577,27104,23351,5665,180649,116087,13681,28996,3549,2711,-71.3,0,100.66,206681,368429,-161748
2035-08,400434,41529,44921,13231,92069,204302,19410,18479,818,3902,474.24,1,105.24,441963,392412,49551
2035-09,333164,28585,22858,10447,171502,133544,13251,31883,676,1543,536.23,1,127.27,361749,383485,-21736
2035-10,101867,46153,32315,11595,134433,142780,11011,25639,3738,3184,-2.95,1,85.68,148020,357773,-209753
2035-11,423388,34026,26144,6640,163714,135520,21331,28772,2226,732,166.25,0,94.79,457414,382121,75293
2035-12,222059,26430,39013,13890,142654,55254,16613,28014,958,1870,174.98,1,123.93,248489,295438,-46949
2036-01,266515,31011,25615,9997,163837,149347,14524,24390,4523,954,-47.59,0,89.79,297526,387710,-90184
2036-02,290689,19594,27495,13962,135372,88035,15307,28748,4931,1577,151.02,0,129.3,310283,308919,1364
2036-03,237938,16746,38889,12927,144486,211241,16856,34434,1659,3458,129.25,1,148.9,254684,458833,-204149
2036-04,151289,14191,28089,10164,129243,116415,29849,39941,2763,2471,69.32,1,92.79,165480,353701,-188221
2036-05,394347,27801,30997,6991,184440,129559,12304,15360,606,3079,709.31,0,145.2,422148,379651,42497
2036-06,307135,41125,39815,13395,144588,80156,5844,9815,3727,779,87.33,0,99.73,348260,293613,54647
2036-07,410159,46121,28924,12972,123408,130175,23878,21485,2490,2667,153.14,0,114.53,456280,340842,115438
2036-08,288600,15637,38320,10247,194476,223996,27013,6522,4612,578,-63.65,1,146.02,304237,500574,-196337
2036-09,218096,10843,35686,11302,158955,215783,16296,36169,1733,3976,135.55,1,121.78,228939,474191,-245252
2036-10,356053,13603,39081,14668,140685,119250,5881,35858,4077,3750,72.88,1,83.04,369656,355423,14233
2036-11,494901,10161,33877,12938,155145,60144,6175,18641,4537,2301,131.37,0,99.56,505062,286920,218142
2036-12,330745,30794,34978,13294,168472,155404,7760,16945,3677,3903,52.85,1,83.09,361539,396853,-35314
2037-01,418972,16739,21656,11614,180206,197214,13164,22895,2378,2985,150.0,0,136.87,435711,446749,-11038
2037-02,444089,32538,46143,14980,194694,154475,25246,10565,4266,1772,168.24,0,142.88,476627,446103,30524
2037-03,396045,31019,23705,5457,186341,84921,14059,17274,3312,3130,69.14,1,89.85,427064,331757,95307
2037-04,251303,37166,47806,9710,95591,217290,5740,28947,2972,603,142.73,1,88.07,288469,405084,-116615
2037-05,468101,34514,23686,14838,97008,248963,23644,24235,1125,1426,425.15,0,144.06,502615,432374,70241
2037-06,171078,36833,40042,11113,95731,151014,28605,10981,2510,3292,76.11,0,95.08,207911,337486,-129575
2037-07,486313,34091,49713,7417,118844,153122,11665,10872,3638,3106,132.07,0,142.83,520404,351633,168771
2037-08,301278,25437,26822,6343,177335,99313,15992,18996,3402,2267,87.82,1,123.6,326715,344801,-18086
2037-09,257388,15492,21446,10185,123354,124353,27247,7430,2580,2972,109.21,1,129.69,272880,314015,-41135
2037-10,179378,41849,25309,7900,169852,209504,28749,7897,4695,1363,30.73,1,137.66,221227,449211,-227984
2037-11,181653,22648,24322,12880,168605,132376,27164,16258,3565,823,11.17,0,99.72,204301,381605,-177304
2037-12,167721,39855,36899,5966,163624,145207,24136,34297,1390,746,138.29,1,143.37,207576,410129,-202553
2038-01,437967,21639,33811,14568,121274,233645,12189,35851,4920,2905,105.65,0,131.76,459606,451338,8268
2038-02,293250,38785,24683,6978,142007,58171,16461,32512,558,2779,537.72,0,108.84,332035,280812,51223
2038-03,319739,45728,28875,8614,165041,236624,6624,35261,3470,3174,94.92,1,91.3,365467,481039,-115572
2038-04,377264,11338,30798,7694,197910,214428,24595,28006,2137,1925,166.68,1,146.0,388602,503431,-114829
2038-05,313200,25706,20465,7838,143567,133855,29059,21456,611,746,536.22,0,129.65,338906,356240,-17334
2038-06,109306,45373,24355,9461,140596,174125,8624,36428,1690,2832,168.66,0,138.95,154679,393589,-238910
2038-07,415805,25249,26128,7954,130948,79522,13733,11772,2563,365,50.65,0,80.02,441054,270057,170997
2038-08,413831,13865,42588,5243,119846,96795,9713,32096,4413,3341,143.55,1,118.45,427696,306281,121415
2038-09,416416,11009,32311,5997,156411,139358,19793,33325,1893,2624,212.49,1,138.51,427425,387195,40230
2038-10,407249,47631,45711,8131,167623,210638,29374,18804,1557,3983,225.66,1,113.07,454880,480281,-25401
2038-11,305958,49890,29462,6492,135532,219486,22185,14948,2324,2947,70.55,0,85.61,355848,428105,-72257
2038-12,394471,18104,42580,9526,124544,85853,5733,5902,2395,349,85.14,1,145.46,412575,274138,138437
2039-01,296855,30646,25541,11776,150760,65387,13670,24865,1860,3025,148.17,0,80.2,327501,291999,35502
2039-02,150095,37180,49852,6990,155765,108188,11430,17964,2191,468,96.16,0,100.46,187275,350189,-162914
2039-03,385900,18410,24805,12407,120276,83382,13517,34329,4346,1494,-11.18,1,92.55,404310,288716,115594
2039-04,133275,20455,27962,11450,101687,182713,18283,37908,2691,3315,-3.0,1,113.21,153730,380003,-226273
2039-05,366793,17682,32360,7546,149412,80475,18123,29577,746,1695,506.15,0,106.46,384475,317493,66982
2039-06,308930,40041,23813,11916,157974,113263,11982,7652,2812,3461,101.5,0,103.88,348971,326600,22371
2039-07,392935,47421,26824,9021,160052,137366,20401,32280,3865,373,19.53,0,93.91,440356,385944,54412
2039-08,263199,31551,41777,10298,140463,62786,27171,21939,2690,3936,119.39,1,129.88,294750,304434,-9684
2039-09,429456,46851,25384,11642,105918,100899,20287,33643,772,2673,485.44,1,140.66,476307,297773,178534
2039-10,149116,28395,46823,8461,175624,93557,20418,5690,2523,2609,59.7,1,142.46,177511,350573,-173062
2039-11,310065,24791,20905,12281,126196,53859,20087,6388,4597,1320,68.2,0,116.84,334856,239716,95140
2039-12,487612,38126,35319,9319,98742,122860,16233,17065,4082,3779,123.26,1,98.95,525738,299538,226200
2040-01,310345,23181,37799,10569,93752,153533,27090,24459,780,2789,419.79,0,141.45,333526,347202,-13676
2040-02,177845,29028,39898,12026,190317,115249,10975,14694,980,1073,109.27,0,128.7,206873,383159,-176286
2040-03,142167,30653,49133,13205,128002,125045,7565,11645,4992,3032,51.81,1,147.12,172820,334595,-161775
2040-04,232930,26855,26353,9882,126854,87297,18258,26429,3055,3805,56.15,1,125.88,259785,295073,-35288
2040-05,182529,18302,27796,11764,103107,196151,7433,6792,1854,3034,73.32,0,114.93,200831,353043,-152212
2040-06,288827,48224,43074,11986,135981,113710,21713,6712,2315,1807,216.71,0,111.49,337051,333176,3875
2040-07,295057,13700,34294,8925,117634,72361,10108,21515,2114,3089,96.98,0,80.77,308757,264837,43920
2040-08,225526,35559,48665,9873,91880,63291,26137,36921,4165,1923,62.16,1,101.25,261085,276767,-15682
2040-09,242876,27428,28881,14324,136159,229438,5263,39936,1992,2016,149.75,1,108.89,270304,454001,-183697
2040-10,235940,45587,33374,7820,161837,88789,17497,34815,4354,388,171.0,1,124.44,281527,344132,-62605
2040-11,101187,22116,48475,13638,124172,213960,5495,20354,3303,3903,14.77,0,121.78,123303,426094,-302791
2040-12,358451,18387,48290,12238,104165,223997,27058,11538,4160,2712,90.92,1,111.33,376838,427286,-50448
2041-01,255267,38754,32308,6355,132884,79000,28021,16663,2892,367,68.32,0,105.17,294021,295231,-1210
2041-02,369979,20326,48274,9655,132251,239442,12462,22874,2415,1265,150.39,0,108.65,390305,464958,-74653
2041-03,475985,36027,24500,14154,156759,185400,29651,28516,4010,2662,158.09,1,101.36,512012,438980,73032
2041-04,375466,24258,36397,6667,95072,205614,11923,19048,1068,580,391.31,1,145.12,399724,374721,25003
2041-05,439618,29992,31609,5337,104411,161609,16991,15302,2370,1119,149.6,0,82.9,469610,335259,134351
2041-06,302056,32365,41098,6110,173078,67436,22585,36338,3866,894,-27.94,0,92.84,334421,346645,-12224
2041-07,378532,17174,40285,13473,137513,115752,19126,15470,3856,1175,133.08,0,108.16,395706,341619,54087
2041-08,162625,12404,40807,11515,88425,212745,16065,29045,3312,1369,63.51,1,113.09,175029,398602,-223573
2041-09,153589,40539,23072,5615,84144,116366,29106,6076,2300,1592,-21.26,1,145.6,194128,264379,-70251
2041-10,488173,14104,39827,12793,156413,91091,6953,9038,3542,1008,118.97,1,97.14,502277,316115,186162
2041-11,314805,35913,43229,14352,144079,134350,5074,24816,766,362,373.42,0,123.82,350718,365900,-15182
2041-12,145039,46889,46225,14913,114745,185361,29916,38900,4056,3072,29.74,1,116.39,191928,430060,-238132
2042-01,449027,48803,46220,12662,184045,221648,27546,30373,2789,1485,107.38,0,102.03,497830,522494,-24664
2042-02,304096,20372,29268,9574,110387,248148,9843,7105,4031,3530,94.41,0,145.59,324468,414325,-89857
2042-03,210261,49675,39802,7893,127597,241420,19665,16471,2308,3276,147.52,1,106.65,259936,452848,-192912
2042-04,232449,21255,21658,10572,189373,210269,28455,18698,555,3550,469.18,1,85.77,253704,479025,-225321
2042-05,283870,23543,39022,13892,159361,190637,20454,10819,2323,2181,119.84,0,83.0,307413,434185,-126772
2042-06,345903,35193,47897,8186,122890,97474,7659,19099,3990,3930,125.37,0,103.49,381096,303205,77891
2042-07,187973,47362,27966,11634,92667,138282,29584,21376,4990,1542,-12.46,0,99.53,235335,321509,-86174
2042-08,119845,40285,39122,11683,189834,85738,8568,36499,1988,1707,17.53,1,84.88,160130,371444,-211314
2042-09,112427,45998,43119,10872,183076,73335,6290,7621,1028,350,170.03,1,89.85,158425,324313,-165888
2042-10,272450,30913,33972,13855,96150,145559,11829,22568,4490,3334,27.36,1,132.77,303363,323933,-20570
2042-11,273937,36828,45456,8690,154284,218493,9048,36106,3627,1907,1.18,0,116.65,310765,472077,-161312
2042-12,404456,10881,24821,12718,109939,134070,16880,6611,945,1535,430.29,1,143.7,415337,305039,110298
2043-01,121371,45380,24094,14089,90866,80411,25576,34931,1718,3205,59.12,0,112.77,166751,269967,-103216
2043-02,488074,24635,40736,6343,199238,131853,7513,32907,3664,2085,129.05,0,110.1,512709,418590,94119
2043-03,450529,37882,39387,14469,193820,189168,9843,24282,921,2369,524.11,1,80.11,488411,470969,17442
2043-04,266191,27627,48784,9753,196435,85551,21891,5903,620,1339,462.77,1,121.06,293818,368317,-74499
2043-05,303066,39963,47278,7506,160675,94134,24927,27069,542,323,493.53,0,130.81,343029,361589,-18560
2043-06,352127,21981,25394,14964,81574,77453,14523,19662,3276,3137,152.09,0,140.56,374108,233570,140538
2043-07,275375,49541,44489,12590,80631,126642,26036,11057,1672,2593,145.15,0,121.58,324916,301445,23471
2043-08,296370,41301,30665,13759,117455,129210,9579,16601,4797,1909,168.37,1,88.46,337671,317269,20402
2043-09,442814,30947,30182,10074,154072,85901,5044,34598,1000,3890,443.37,1,129.46,473761,319871,153890
2043-10,387628,16818,49860,7912,196229,113446,9633,39335,2837,2038,48.47,1,124.98,404446,416415,-11969
2043-11,244920,38857,23056,12707,84571,150139,22119,19009,2595,2446,82.86,0,115.78,283777,311601,-27824
2043-12,268503,14893,21114,12394,179598,233814,8464,27932,3163,1266,32.6,1,100.52,283396,483316,-199920
2044-01,344589,12143,38006,7991,165714,214117,28629,19833,3239,3012,13.64,0,123.95,356732,474290,-117558
2044-02,237077,23667,40331,14772,122599,249868,8812,28614,2264,2324,141.75,0,112.14,260744,464996,-204252
2044-03,365547,20381,32370,11931,199321,238063,28586,30692,3303,3535,128.79,1,98.04,385928,540963,-155035
2044-04,475607,48744,42611,11831,164987,72037,17053,6486,3211,309,201.0,1,109.55,524351,315005,209346
2044-05,170617,46333,24689,6855,175029,184783,23258,33234,4004,1178,80.32,0,118.46,216950,447848,-230898
2044-06,282660,20461,21809,6649,193227,197463,17876,14597,4675,2351,37.91,0,96.16,303121,451621,-148500
2044-07,311800,21801,32555,8619,143948,159724,5599,11676,1918,2179,285.13,0,127.59,333601,362121,-28520
2044-08,364865,41908,40392,11914,147321,90289,29809,15864,2529,2277,113.28,1,145.59,406773,335589,71184
2044-09,227041,48945,33646,8005,100446,168349,6753,9795,3645,1107,184.2,1,122.96,275986,326994,-51008
2044-10,442151,34691,47853,8431,194284,57280,20794,8117,2924,3300,132.47,1,88.69,476842,336759,140083
2044-11,311201,29879,41328,13459,88914,146225,26681,9952,1697,3026,142.14,0,149.15,341080,326559,14521
2044-12,361260,15549,29058,6629,182632,220898,13307,24613,614,1524,552.29,1,87.22,376809,477137,-100328
2045-01,162685,25631,20660,11700,96838,231058,24137,23193,3695,1992,25.16,0,126.19,188316,407586,-219270
2045-02,203836,12226,45829,11167,123652,140026,26069,23339,3762,607,13.68,0,102.41,216062,370082,-154020
2045-03,495352,28384,46567,12387,197983,176643,5316,14231,1706,1007,313.95,1,142.05,523736,453127,70609
2045-04,174667,35552,29714,12866,148132,83824,6320,11883,4055,1005,-11.73,1,125.57,210219,292739,-82520
2045-05,262256,45747,24013,8299,82818,113705,20851,37777,3744,3801,139.31,0,119.61,308003,287463,20540
2045-06,121708,36689,49623,8617,165067,208689,6971,29440,2114,3765,29.71,0,87.77,158397,468407,-310010
2045-07,413068,25803,33672,13424,81645,88195,23841,34141,3800,3608,68.53,0,89.54,438871,274918,163953
2045-08,211075,30658,21430,9346,95131,248495,29314,5176,3824,3556,4.01,1,99.06,241733,408892,-167159
2045-09,232011,46078,32355,10723,87398,239651,16000,31806,2718,1723,99.45,1,132.44,278089,417933,-139844
2045-10,328678,10066,27989,12277,154411,205122,7028,8802,2515,2830,43.25,1,121.96,338744,415629,-76885
2045-11,164125,43266,26225,8003,85638,203162,29542,15573,3387,2580,12.96,0,107.67,207391,368143,-160752
2045-12,289102,21614,40239,9063,177357,99253,25065,35228,4261,1054,68.61,1,131.69,310716,386205,-75489
2046-01,420931,49488,27295,6344,104008,156396,11672,22681,3620,993,228.57,0,115.56,470419,328396,142023
2046-02,356869,20500,24253,9332,94240,148827,28358,16036,1904,3960,195.32,0,139.63,377369,321046,56323
2046-03,109490,46470,48154,7908,143842,162057,21409,33484,2226,1155,51.0,1,133.18,155960,416854,-260894
2046-04,118438,27088,22796,8070,113843,136340,17865,36778,3246,3733,55.19,1,119.2,145526,335692,-190166
2046-05,476596,47172,49781,6991,118156,157716,9681,22884,3790,2142,42.59,0,96.25,523768,365209,158559
2046-06,235439,17095,24276,12840,196200,194724,11302,38540,3410,1342,52.98,0,138.74,252534,477882,-225348
2046-07,288870,42771,46543,10414,161179,190369,22020,35991,1719,2570,186.79,0,103.95,331641,466516,-134875
2046-08,459883,17780,22348,7117,174601,213364,25942,10569,604,3294,732.05,1,115.15,477663,453941,23722
2046-09,354100,14019,24071,6124,193756,125799,13625,32617,2075,2780,238.69,1,116.99,368119,395992,-27873
2046-10,111970,18901,30487,12727,148087,152004,26800,33771,2536,3501,68.27,1,88.32,130871,403876,-273005
2046-11,342766,13337,31546,6900,86405,197378,5416,30351,1269,2232,321.97,0,135.93,356103,357996,-1893
2046-12,382172,13868,24239,6009,137766,170829,26207,8282,1979,2109,139.38,1,93.96,396040,373332,22708
2047-01,396406,27305,30431,5413,109509,235634,12854,32194,1092,2833,315.82,0,126.45,423711,426035,-2324
2047-02,182209,43366,24794,13767,150520,149156,23841,28741,2622,1987,103.28,0,81.96,225575,390819,-165244
2047-03,133883,21543,37206,14550,85002,138046,26253,25305,4661,847,2.82,1,98.36,155426,326362,-170936
2047-04,224395,39333,24384,13385,162048,84483,17597,31209,4541,1530,96.23,1,119.58,263728,333106,-69378
2047-05,435839,38239,23047,14197,176650,66743,12256,39719,658,2413,702.71,0,109.84,474078,332612,141466
2047-06,338459,22721,39531,10870,156552,216914,9091,21116,4528,3449,144.5,0,84.86,361180,454074,-92894
2047-07,475568,15155,41851,14509,88567,61686,25174,39124,3194,1700,191.43,0,114.31,490723,270911,219812
2047-08,393015,16652,22405,6875,148344,206394,11840,39994,560,2692,677.55,1,98.82,409667,435852,-26185
2047-09,342324,24074,47484,10977,181874,248236,16249,6233,1082,2830,284.84,1,105.74,366398,511053,-144655
2047-10,220530,35887,25883,6562,165483,175941,23076,27027,3898,3690,58.38,1,132.15,256417,423972,-167555
2047-11,148991,27769,37290,6654,162734,81712,18772,31493,3767,1978,96.81,0,116.13,176760,338655,-161895
2047-12,272714,44554,42015,10822,140661,127541,16934,24965,3401,2079,37.06,1,95.2,317268,362938,-45670
2048-01,209971,13646,35932,13743,150795,246737,7370,13444,3558,969,91.37,0,134.98,223617,468021,-244404
2048-02,162022,26830,45713,12637,162483,130812,28451,34941,1966,2647,66.71,0,126.63,188852,415037,-226185
2048-03,474695,44800,48950,11551,181545,237318,24887,39338,3144,1107,147.64,1,144.69,519495,543589,-24094
2048-04,335725,27512,30996,6713,85688,118076,5353,19918,1483,2398,202.85,1,109.77,363237,266744,96493
2048-05,384970,14784,49238,14724,197519,116666,21704,21141,3730,3115,85.68,0,132.08,399754,420992,-21238
2048-06,378212,26341,22740,10124,185053,172079,5673,27271,1760,1970,245.22,0,106.14,404553,422940,-18387
2048-07,480032,35074,29453,13643,90749,228271,29711,11217,2861,1561,214.2,0,131.48,515106,403044,112062
2048-08,381083,29718,24574,11260,157587,64630,20879,9908,1534,2949,310.78,1,112.19,410801,288838,121963
2048-09,280304,44966,48436,5612,145338,220777,26921,35059,851,2466,360.1,1,111.47,325270,482143,-156873
2048-10,442428,25054,28258,6069,169351,102185,20013,25629,1534,1945,196.32,1,143.56,467482,351505,115977
2048-11,217723,40209,32054,12996,162717,129605,23005,15789,2192,2418,70.92,0,122.06,257932,376166,-118234
2048-12,329418,36442,28821,10486,97825,104730,6342,34244,3198,1893,103.81,1,142.25,365860,282448,83412
2049-01,278556,41562,25760,12732,154336,248986,5873,10873,4931,2972,97.21,0,126.51,320118,458560,-138442
2049-02,383452,22776,28893,10883,172927,68019,5328,37677,3384,717,103.14,0,99.29,406228,323727,82501
2049-03,437028,46715,44735,5603,148131,203392,16139,28613,1443,2376,282.18,1,130.92,483743,446613,37130
2049-04,305610,37479,26183,9130,111209,196978,6492,13535,770,3687,266.8,1,100.55,343089,363527,-20438
2049-05,327081,13172,25365,6359,198026,153134,16267,36451,4003,1003,134.71,0,92.35,340253,435602,-95349
2049-06,402185,37126,29722,9235,93589,92165,26035,11349,2027,1744,196.22,0,111.25,439311,262095,177216
2049-07,307222,12438,26210,7398,175595,61050,5248,30564,3750,1944,135.39,0,87.74,319660,306065,13595
2049-08,110545,32766,36332,5047,140608,175096,18060,38142,1133,1907,75.81,1,149.99,143311,413285,-269974
2049-09,288603,15767,42836,6307,96028,112091,20028,26250,2476,754,191.31,1,146.36,304370,303540,830
2049-10,336210,15226,43279,12164,132654,142792,6564,15667,3009,3293,146.45,1,100.75,351436,353120,-1684
2049-11,339584,15322,25473,5838,178553,132389,17070,8637,3152,3915,112.08,0,103.69,354906,367960,-13054
2049-12,475804,36696,22274,10794,182146,182085,12871,13460,2087,1357,179.37,1,132.1,512500,423630,88870
2050-01,401475,10357,31380,9531,180253,234852,22710,34266,4833,2349,99.41,0,135.18,411832,512992,-101160
2050-02,330855,26921,21064,11532,170925,248407,18625,19413,1557,3018,216.55,0,124.69,357776,489966,-132190
2050-03,255760,49715,22449,8083,99138,233768,9253,27426,3850,627,85.11,1,96.65,305475,400117,-94642
2050-04,305844,40404,26521,14155,175235,125018,24604,34606,2040,557,138.77,1,105.59,346248,400139,-53891
2050-05,400504,36689,38843,5976,114599,71322,6080,9182,1873,3752,211.74,0,143.03,437193,246002,191191
2050-06,266642,33042,40729,7772,180946,78201,12506,11404,1823,3192,145.17,0,84.51,299684,331558,-31874
2050-07,180663,49148,48380,10258,192250,165570,20514,17073,4087,2321,76.42,0,135.01,229811,454045,-224234
2050-08,153072,37388,40195,9007,125676,190333,19751,37557,4948,2290,76.8,1,146.77,190460,422519,-232059
2050-09,368087,29661,45551,6475,82641,149986,21737,5676,2830,695,126.11,1,134.14,397748,312066,85682
2050-10,458643,39915,27519,13281,102824,70532,18425,27074,4499,3720,153.69,1,94.3,498558,259655,238903
2050-11,490242,35059,30659,9382,174772,206690,7075,15805,4721,1509,105.59,0,93.04,525301,444383,80918
2050-12,225363,20973,41733,11224,88777,86070,12394,5592,1037,1876,257.5,1,148.09,246336,245790,546
2051-01,382670,17402,27708,12552,103260,202523,23427,22566,2752,1131,127.07,0,134.8,400072,392036,8036
2051-02,335779,33011,36895,11091,135285,197297,29107,35747,3078,334,214.21,0,115.05,368790,445422,-76632
2051-03,143570,35360,26950,7779,151458,110249,15616,32822,4243,2117,7.5,1,119.2,178930,344874,-165944
2051-04,279393,12922,23857,8116,178409,94887,23568,12445,2920,2110,129.47,1,145.03,292315,341282,-48967
2051-05,119674,19668,37525,9801,199529,166860,10308,35375,4766,985,-16.22,0,115.44,139342,459398,-320056
2051-06,199332,26514,26116,12875,95602,122170,23538,13974,1131,1611,168.27,0,108.96,225846,294275,-68429
2051-07,278045,22609,47375,10761,158412,92999,9062,33325,1728,3326,238.02,0,147.42,300654,351934,-51280
2051-08,100557,41532,46999,5313,94368,70718,7108,30139,1715,2459,114.77,1,92.19,142089,254645,-112556
2051-09,429231,30485,27656,7751,183869,109549,16911,25794,1170,550,405.39,1,113.56,459716,371530,88186
2051-10,336989,21724,31167,12704,174978,93700,20027,12008,3430,1476,19.45,1,136.44,358713,344584,14129
2051-11,422528,20073,44534,10274,199114,212913,16837,28507,4417,2510,91.62,0,118.03,442601,512179,-69578
2051-12,256488,15411,36447,7348,144251,128191,12275,39199,3509,3805,-12.36,1,88.93,271899,367711,-95812
2052-01,339284,36662,40931,11034,174006,226685,12291,13130,4864,3949,94.33,0,132.73,375946,478077,-102131
2052-02,373491,12395,49811,6939,144843,187889,21408,23991,2550,1450,182.4,0,145.65,385886,434881,-48995
2052-03,234571,44915,40427,8705,168047,125960,15962,27988,2399,742,135.77,1,142.81,279486,387089,-107603
2052-04,458645,35183,45840,11445,186972,116918,20231,23219,1203,3556,438.67,1,144.19,493828,404625,89203
2052-05,485447,35628,41317,7305,103159,104046,14539,32280,3343,2717,196.24,0,84.86,521075,302646,218429
2052-06,128644,49465,26170,6130,191453,106418,16446,36512,3569,1051,68.83,0,85.28,178109,383129,-205020
2052-07,329247,25338,49689,5598,123459,166899,29001,9819,2927,2791,54.46,0,134.84,354585,384465,-29880
2052-08,109731,46545,46304,6572,103848,229758,6112,10935,4975,3492,-11.55,1,134.23,156276,403529,-247253
2052-09,120257,15185,45286,7577,198926,167286,29848,17565,3912,2422,122.78,1,142.66,135442,466488,-331046
2052-10,377271,25657,22734,12544,104001,60334,7347,33824,872,449,399.9,1,129.46,402928,240784,162144
2052-11,353486,47160,38892,12106,122254,104687,11306,23467,3704,1607,-3.28,0,120.92,400646,312712,87934
2052-12,367994,37195,47439,13971,111194,214513,16141,29473,3183,1085,213.74,1,141.49,405189,432731,-27542
2053-01,339683,46292,28823,11949,199876,223154,11584,36037,1670,2733,164.47,0,115.59,385975,511423,-125448
2053-02,138093,35593,48110,14837,185896,198054,19027,12817,2259,2166,-36.58,0,89.03,173686,478741,-305055
2053-03,108706,20457,23604,10787,137363,106381,24311,17093,4230,3580,89.5,1,145.65,129163,319539,-190376
2053-04,211611,22260,37923,11144,183049,112255,29852,23975,2678,3854,94.38,1,87.26,233871,398198,-164327
2053-05,388966,37702,33495,12524,95638,208366,15449,37908,1862,2954,274.5,0,95.0,426668,403380,23288
2053-06,336434,25137,24062,14683,92192,188943,28614,14352,2963,3022,99.8,0,144.67,361571,362846,-1275
2053-07,387300,17602,24247,10801,103544,61712,25650,33587,2777,693,155.77,0,138.49,404902,259541,145361
2053-08,378032,39734,20128,14625,174066,118917,24142,11763,4829,478,55.02,1,95.07,417766,363641,54125
2053-09,170732,38955,29050,6104,99302,132891,25598,20437,3261,315,-19.1,1,147.93,209687,313382,-103695
2053-10,391762,17386,46457,14248,197349,76341,5275,11504,4197,3600,83.64,1,114.17,409148,351174,57974
2053-11,410522,49907,31997,6553,123248,169863,24041,12826,3243,3038,148.32,0,134.16,460429,368528,91901
2053-12,138744,36004,23018,7299,178414,86870,10989,10066,4401,3725,4.32,1,112.78,174748,316656,-141908
2054-01,121147,22898,38715,11307,126106,186302,5677,20104,927,3565,212.05,0,127.16,144045,388211,-244166
2054-02,380249,20508,46389,9479,89507,225682,7461,29445,2525,395,88.44,0,137.48,400757,407963,-7206
2054-03,437357,28193,32368,13346,158487,224327,28926,10632,1234,3072,355.83,1,95.23,465550,468086,-2536
2054-04,220537,30324,38079,12096,144569,201658,24576,25001,4743,1071,153.43,1,94.9,250861,445979,-195118
2054-05,315153,19629,48304,14334,139972,174450,13157,17099,1432,2572,220.12,0,94.27,334782,407316,-72534
2054-06,357251,36529,49898,10721,109429,232969,14689,32287,3336,658,82.63,0,134.01,393780,449993,-56213
2054-07,216935,36582,49576,8298,160653,193956,25253,12110,4818,3834,0.63,0,114.94,253517,449846,-196329
2054-08,273312,16781,28374,12195,146428,167108,26783,10410,4853,3042,-12.34,1,101.45,290093,391298,-101205
2054-09,329339,37180,30818,13946,197882,124413,16494,31793,4431,612,33.48,1,138.0,366519,415346,-48827
2054-10,121142,24864,23433,7093,197500,237961,26877,33234,1933,3818,129.51,1,108.83,146006,526098,-380092
2054-11,257001,16139,33996,7633,195009,216373,28845,33273,4385,3429,-34.06,0,138.72,273140,515129,-241989
2054-12,436511,43788,21374,8949,166180,169934,22009,16859,1231,1160,281.72,1,132.33,480299,405305,74994
2055-01,209561,11971,40117,12571,166488,98258,24792,34731,4461,2866,-17.93,0,149.89,221532,376957,-155425
2055-02,256220,12799,36483,13689,80338,193074,19649,39395,3235,886,-12.34,0,112.71,269019,382628,-113609
2055-03,137059,46815,46834,10278,121656,140344,9917,22186,3945,3998,-4.76,1,92.61,183874,351215,-167341
2055-04,141275,32942,39889,9100,99894,76929,20165,19303,1692,2444,67.17,1,125.41,174217,265280,-91063
2055-05,129008,36155,35200,6085,183439,141627,8897,38812,3876,336,40.77,0,108.62,165163,414060,-248897
2055-06,140848,20312,35110,7366,181041,112375,13348,9747,3024,2371,122.44,0,136.71,161160,358987,-197827
2055-07,103086,10018,44617,11967,114116,142239,27791,37329,3248,3440,9.47,0,122.85,113104,378059,-264955
2055-08,307174,39482,48650,9555,94896,216749,26765,9196,3110,3230,130.09,1,106.92,346656,405811,-59155
2055-09,139539,18780,44096,8129,171796,116023,26895,12182,1420,3684,119.49,1,80.94,158319,379121,-220802
2055-10,342759,39357,45892,10320,152135,102968,15092,14866,2952,3015,94.36,1,145.4,382116,341273,40843
2055-11,438568,41420,40396,10244,187390,62745,5792,16951,4376,834,92.61,0,122.71,479988,323518,156470
2055-12,349173,23988,47668,7308,145822,124950,28090,16374,1187,2244,376.25,1,127.29,373161,370212,2949
2056-01,114653,22316,20979,7000,105179,115402,6948,19333,2859,390,59.51,0,122.92,136969,274841,-137872
2056-02,280536,19951,31361,11102,132357,118908,26506,15722,1056,512,139.32,0,128.95,300487,335956,-35469
2056-03,308476,14883,21777,12012,84929,63325,17056,38001,3466,2031,112.86,1,92.34,323359,237100,86259
2056-04,412487,31437,34049,5853,82309,219260,12564,22454,1073,634,388.61,1,105.21,443924,376489,67435
2056-05,235976,49113,43141,13099,141096,136598,28135,26483,685,2531,367.96,0,123.71,285089,388552,-103463
2056-06,424724,31323,27259,8758,185831,242512,9967,37001,2016,1808,217.53,0,81.09,456047,511328,-55281
2056-07,147543,49100,26549,8293,132375,166260,16808,24207,3389,700,-31.05,0,83.47,196643,374492,-177849
2056-08,259714,39266,24860,14517,145488,239599,18964,6163,1309,1362,101.4,1,146.27,298980,449591,-150611
2056-09,343109,11491,26420,6515,190429,105474,19731,12453,967,3191,363.76,1,143.65,354600,361022,-6422
2056-10,120416,16193,42169,14499,180849,117166,19926,24321,4728,1909,23.41,1,130.61,136609,398930,-262321
2056-11,494450,40709,40860,13640,122897,110543,6741,13113,4279,2161,76.08,0,112.8,535159,307794,227365
2056-12,127567,37463,46650,7605,91113,174658,9929,16121,1385,1235,155.84,1,115.83,165030,346076,-181046
2057-01,284365,26269,31361,13545,174274,152217,7233,19407,3909,629,21.86,0,114.89,310634,398037,-87403
2057-02,350544,31041,31152,9397,183584,228772,5318,12084,974,1128,317.92,0,92.5,381585,470307,-88722
2057-03,138934,39864,41128,7510,112905,128108,18325,8617,3172,432,37.61,1,130.0,178798,316593,-137795
2057-04,449657,16693,40202,12354,108629,209733,28430,16400,4893,2431,90.4,1,100.26,466350,415748,50602
2057-05,144816,34341,22867,13142,97531,74194,16348,37355,1398,2297,80.67,0,86.25,179157,261437,-82280
2057-06,425310,49189,30937,13330,135044,233858,8304,32207,1561,1736,172.28,0,97.65,474499,453680,20819
2057-07,186493,23760,31530,5607,110054,157055,14542,38886,1452,3404,188.12,0,125.99,210253,357674,-147421
2057-08,345932,37855,36576,13917,184613,203106,15755,36173,2049,2065,92.55,1,129.92,383787,490140,-106353
2057-09,422057,27934,46979,5519,165474,67480,28466,35903,783,1856,543.11,1,86.03,449991,349821,100170
2057-10,278028,13688,27006,14457,142182,176330,10815,11132,4020,2938,75.05,1,147.09,291716,381922,-90206
2057-11,142383,42003,21593,13925,176083,88740,7643,5120,1816,1450,0.28,0,118.42,184386,313104,-128718
2057-12,236910,37344,37836,7558,186498,203941,28280,6483,4704,680,-34.95,1,91.48,274254,470596,-196342
2058-01,296714,24629,27870,6069,121200,238538,13347,16839,3975,2406,110.91,0,84.21,321343,423863,-102520
2058-02,398261,24113,34962,14447,114064,128435,7832,31664,4828,1462,-6.46,0,144.49,422374,331404,90970
2058-03,366542,15672,22918,10998,92632,193551,13887,22747,2863,1953,89.76,1,129.62,382214,356733,25481
2058-04,456043,21693,20356,9732,89604,76823,21331,5854,804,3705,475.26,1,138.29,477736,223700,254036
2058-05,304720,29463,22574,6935,109036,154390,22214,7599,4571,3969,64.08,0,126.09,334183,322748,11435
2058-06,142530,18656,32417,5757,85680,70239,10948,33640,3264,2299,13.06,0,100.5,161186,238681,-77495
2058-07,351698,15670,48874,6104,139204,248548,18827,18417,3308,2641,194.86,0,109.74,367368,479974,-112606
2058-08,356041,16908,32233,5149,198799,116272,18525,9039,2208,3099,102.9,1,133.23,372949,380017,-7068
2058-09,199444,44156,37319,8993,160124,188298,26333,21616,2457,1381,140.02,1,113.49,243600,442683,-199083
2058-10,443715,49811,28829,14155,130363,79412,8978,23660,670,1540,652.77,1,113.57,493526,285397,208129
2058-11,172123,48212,20063,11059,104358,112662,29540,39927,1532,620,168.21,0,97.55,220335,317609,-97274
2058-12,348040,45308,48192,12039,174025,178186,7321,16565,3473,2352,122.14,1,132.73,393348,436328,-42980
2059-01,274445,25814,37747,10850,133972,180812,14370,25002,1407,568,117.43,0,135.14,300259,402753,-102494
2059-02,340462,36005,44668,11094,95063,243002,6291,20147,1877,2319,166.61,0,88.86,376467,420265,-43798
2059-03,400870,43372,25546,13678,189192,86390,17145,17168,2785,1686,204.46,1,134.33,444242,349119,95123
2059-04,373623,37863,38329,11863,150234,166831,23305,17244,1183,3976,240.49,1,111.4,411486,407806,3680
2059-05,223275,26557,37053,11031,182292,95842,25166,8981,3827,3151,107.57,0,138.85,249832,360365,-110533
2059-06,185269,30634,45772,8175,121302,109238,21491,36140,2907,407,23.39,0,148.12,215903,342118,-126215
2059-07,470373,25582,44041,14012,139734,122844,28557,5537,1232,1230,418.06,0,84.34,495955,354725,141230
2059-08,420931,29195,23099,14364,145713,93673,16152,31317,4831,1594,166.54,1,119.38,450126,324318,125808
2059-09,238514,26279,23080,8021,138359,215943,16142,25881,854,1916,262.95,1,103.01,264793,427426,-162633
2059-10,442586,26118,22479,6961,83547,233825,26078,39732,4920,3475,86.06,1,144.0,468704,412622,56082
2059-11,158711,49653,28060,5054,84202,223664,22090,32728,1167,3105,78.18,0,110.73,208364,395798,-187434
2059-12,360476,40921,25541,6044,140385,162313,10843,13130,704,2995,457.81,1,114.12,401397,358256,43141
2060-01,156911,32321,20246,7327,151892,109746,28633,36668,4415,1190,3.21,0,120.67,189232,354512,-165280
2060-02,363102,15205,35404,5628,153352,195836,15228,12315,3430,3149,94.22,0,87.53,378307,417763,-39456
2060-03,480152,40619,20768,6544,189432,118930,6224,30600,2069,3343,350.49,1,128.6,520771,372498,148273
2060-04,120299,19383,45563,11641,136485,55670,6643,35026,3484,3378,45.69,1,100.16,139682,291028,-151346
2060-05,157488,44195,30844,10703,170624,198280,21865,31822,2270,2633,109.03,0,131.68,201683,464138,-262455
2060-06,220847,32979,20320,7809,178696,127968,17855,8228,2099,2761,162.49,0,82.56,253826,360876,-107050
2060-07,245734,18977,47947,13384,179454,86051,20645,39442,2994,1524,62.8,0,124.28,264711,386923,-122212
2060-08,494354,23836,25788,13031,90660,234766,5698,11197,1072,3198,463.95,1,98.13,518190,381140,137050
2060-09,112313,21067,34062,5823,130929,154117,19431,37534,2674,3972,-52.24,1,128.64,133380,381896,-248516
2060-10,331145,19195,46801,8321,98257,73283,20936,18276,4260,1489,117.89,1,89.46,350340,265874,84466
2060-11,265941,32794,21532,13989,188601,138379,18978,34717,4249,1373,-0.4,0,92.76,298735,416196,-117461
2060-12,473375,12363,48042,12319,124352,111774,28384,6122,1385,3249,386.77,1,145.46,485738,330993,154745
2061-01,353769,30900,49458,11552,128016,110564,20836,32435,702,3379,450.46,0,103.58,384669,352861,31808
2061-02,128660,38524,43128,13393,183573,195443,13594,33370,2723,939,84.78,0,133.84,167184,482501,-315317
2061-03,351679,33468,45215,13552,133513,209929,8859,5065,4751,3779,96.53,1,80.84,385147,416133,-30986
2061-04,219037,16436,36844,5936,196689,220140,8736,26394,1724,2922,178.44,1,89.99,235473,494739,-259266
2061-05,372641,43792,28825,5306,160176,178777,8680,37938,3729,2185,120.36,0,83.46,416433,419702,-3269
2061-06,435544,16766,40044,7872,196172,69736,16542,23066,521,2563,824.77,0,146.7,452310,353432,98878
2061-07,146939,26314,31738,8776,98193,158615,12134,31729,3947,2653,67.98,0,123.19,173253,341185,-167932
2061-08,491859,15324,34926,6729,120212,119273,8638,38674,4451,1084,142.83,1,103.17,507183,328452,178731
2061-09,355865,24205,23653,12593,85483,128305,23205,8282,1597,2509,260.35,1,81.8,380070,281521,98549
2061-10,454993,33202,21080,12430,194991,136305,17498,34262,3616,2359,194.49,1,144.16,488195,416566,71629
2061-11,319544,29075,35786,11394,112558,194635,27982,13224,2086,2113,231.3,0,145.23,348619,395579,-46960
2061-12,259694,47021,30229,13800,141830,86392,17163,31953,1728,2560,229.5,1,126.82,306715,321367,-14652
2062-01,275588,49104,44892,7598,192080,136895,21028,34461,3345,1073,138.44,0,96.77,324692,436954,-112262
2062-02,282069,16777,37527,9190,179492,197006,9304,27068,4496,3091,85.03,0,106.39,298846,459587,-160741
2062-03,448977,42600,42159,7170,179878,96994,20234,12035,642,3087,656.12,1,149.15,491577,358470,133107
2062-04,162276,18209,49402,14867,113779,158272,13253,29181,2698,2609,28.98,1,103.6,180485,378754,-198269
2062-05,375209,23074,37082,12570,107327,133261,13509,7323,3487,486,138.24,0,110.08,398283,311072,87211
2062-06,444728,38326,43020,9490,170966,183972,18605,14400,4344,2777,141.97,0,109.46,483054,440453,42601
2062-07,124062,41233,35899,10543,116905,211985,13424,8386,1081,2907,146.06,0,95.58,165295,397142,-231847
2062-08,280235,47620,20779,6747,103932,60719,18840,18840,4812,2202,17.36,1,102.7,327855,229857,97998
2062-09,206998,31018,28121,12127,189005,113166,16203,23861,1994,1972,63.99,1,132.91,238016,382483,-144467
2062-10,317169,34394,22215,9246,147912,61489,6735,35116,1254,3950,242.6,1,111.89,351563,282713,68850
2062-11,401407,32510,28392,11840,113822,148044,11147,23527,2561,852,149.6,0,112.58,433917,336772,97145
2062-12,417023,22997,44214,11473,122876,209658,18568,10248,3307,590,167.25,1,119.06,440020,417037,22983
2063-01,173743,18265,34023,13027,186193,89222,7302,36495,1536,2450,119.82,0,89.47,192008,366262,-174254
2063-02,448399,11759,44724,10698,152868,90208,25622,29944,3502,842,8.98,0,145.25,460158,354064,106094
2063-03,433774,23419,35557,11147,161065,170256,9688,29370,2606,3620,114.89,1,117.3,457193,417083,40110
2063-04,481210,29114,23072,12146,133280,215318,24627,14330,2423,3925,227.83,1,113.27,510324,422773,87551
2063-05,289213,38199,20352,9321,90296,62323,6686,21474,3891,3185,93.21,0,133.29,327412,210452,116960
2063-06,430080,39608,30134,13852,146143,215557,22405,11731,4514,1630,153.34,0,134.81,469688,439822,29866
2063-07,292229,14174,25165,5683,160530,154648,10289,30868,3496,1859,194.13,0,148.3,306403,387183,-80780
2063-08,406534,32390,23880,11339,168163,134999,19724,17248,1366,2819,245.06,1,117.1,438924,375353,63571
2063-09,290956,35557,36831,9059,135110,204609,28595,7896,3522,952,100.83,1,126.9,326513,422100,-95587
2063-10,326926,17616,49889,7651,168539,228861,13548,38750,2795,3688,79.43,1,90.65,344542,507238,-162696
2063-11,236443,34533,48957,10276,158257,94273,18987,12108,2377,366,148.49,0,95.14,270976,342858,-71882
2063-12,357560,45614,24256,6636,179734,160035,24483,18884,552,2026,718.51,1,130.32,403174,414028,-10854
2064-01,303613,15130,32302,5307,161025,177197,24952,22371,2846,2228,99.84,0,142.27,318743,423154,-104411
2064-02,317375,39216,27148,12656,165372,110857,25125,13509,2215,2200,172.68,0,101.53,356591,354667,1924
2064-03,284521,49306,25042,5931,120918,226710,18972,6372,4033,625,26.37,1,144.52,333827,403945,-70118
2064-04,463850,11940,41904,13329,134203,149630,15492,38755,1749,303,281.38,1,107.14,475790,393313,82477
2064-05,206019,29893,20636,14103,103850,175378,28062,6964,4711,1489,40.08,0,137.17,235912,348993,-113081
2064-06,483197,45764,34550,14333,188297,76191,16310,19954,1038,523,494.22,0,87.38,528961,349635,179326
2064-07,258553,44951,25399,9430,114269,77948,24587,30006,2814,1552,66.61,0,90.59,303504,281639,21865
2064-08,254203,46199,28357,11042,168985,50084,7325,34038,2532,2825,57.86,1,107.94,300402,299831,571
2064-09,213219,47616,45159,11104,152610,127361,5514,7563,2505,419,22.1,1,145.93,260835,349311,-88476
2064-10,236616,46922,39248,11635,131578,169493,18133,36170,3274,1992,-3.09,1,95.58,283538,406257,-122719
2064-11,485528,37062,39196,14555,129035,60322,24804,35860,840,988,625.4,0,84.18,522590,303772,218818
2064-12,458465,37849,28205,10642,84563,146279,27992,38293,541,1307,824.4,1,113.99,496314,335974,160340
2065-01,115907,15834,20401,7371,171219,247352,6928,15909,1867,1520,133.04,0,120.43,131741,469180,-337439
2065-02,394644,30688,22155,7517,170276,54623,16963,18316,1552,1296,312.51,0,84.16,425332,289850,135482
2065-03,354576,11026,38035,6201,195340,231954,28240,14315,3440,651,175.39,1,117.17,365602,514085,-148483
2065-04,373848,46810,31180,14262,91442,199269,11325,20009,4188,2687,73.76,1,137.38,420658,367487,53171
2065-05,272412,31772,39256,6082,96070,185896,19434,26304,3904,2140,178.52,0,148.8,304184,373042,-68858
2065-06,399836,47068,22473,13269,84927,105310,28512,30178,1961,2124,239.04,0,132.19,446904,284669,162235
2065-07,316559,41136,34533,8623,91933,196108,24898,19709,3722,3750,87.89,0,146.56,357695,375804,-18109
2065-08,156387,43294,46227,12495,140481,83710,8545,15456,4745,3661,-66.75,1,118.04,199681,306914,-107233
2065-09,338713,41693,46176,12023,180707,127161,5521,37174,4041,2844,44.73,1,101.49,380406,408762,-28356
2065-10,420338,29639,29142,7592,101870,205570,15300,37255,4073,2615,47.14,1,116.81,449977,396729,53248
2065-11,445799,11526,45756,11824,149434,223967,13068,24630,2254,3190,221.71,0,145.43,457325,468679,-11354
2065-12,389527,46657,26408,6759,180382,80258,29042,20568,2913,3021,156.94,1,102.19,436184,343417,92767
2066-01,171065,13522,25056,14854,97959,68014,12845,35780,4772,1741,63.4,0,97.18,184587,254508,-69921
2066-02,293297,20761,35539,5712,168032,236056,22681,28858,2188,940,107.22,0,124.63,314058,496878,-182820
2066-03,434514,33677,21388,9446,185486,148599,7814,36164,3789,2704,59.17,1,130.4,468191,408897,59294
2066-04,378805,20852,23199,13207,199393,82922,23795,8730,4744,1139,-12.57,1,87.07,399657,351246,48411
2066-05,253243,20372,41615,8057,150812,103622,26717,28599,4677,631,58.26,0,95.57,273615,359422,-85807
2066-06,403427,38753,48341,14629,167758,249461,8056,38071,2930,2921,166.43,0,142.58,442180,526316,-84136
2066-07,273600,32654,41905,12235,171184,58107,10632,13538,1395,428,192.92,0,110.63,306254,307601,-1347
2066-08,125488,16282,32283,12385,85972,191492,6854,23201,2640,2662,31.57,1,109.21,141770,352187,-210417
2066-09,250143,37430,23450,12779,93559,87960,12008,33355,1041,3530,316.31,1,135.51,287573,263111,24462
2066-10,352821,39750,22941,6922,168546,57739,23891,30296,2685,3802,88.6,1,95.48,392571,310335,82236
2066-11,261233,36147,35528,13800,104563,169862,17491,13670,3293,1968,83.52,0,106.86,297380,354914,-57534
2066-12,109503,27641,38006,10095,80368,180809,29773,14458,2677,2476,9.19,1,126.55,137144,353509,-216365
2067-01,408198,36898,24233,5748,130801,79791,5456,29895,637,2592,678.78,0,127.45,445096,275924,169172
2067-02,494514,26406,38685,11395,180443,174615,7961,8747,4715,3435,187.98,0,114.61,520920,421846,99074
2067-03,437365,27923,26680,12026,106487,238873,18033,28801,3501,1435,171.36,1,105.36,465288,430900,34388
2067-04,200828,25029,45979,10423,144065,168936,5276,38736,3623,1245,74.2,1,117.9,225857,413415,-187558
2067-05,278036,12873,26973,6125,157839,156934,7917,39201,3867,3786,37.95,0,93.31,290909,394989,-104080
2067-06,117643,45876,28732,6189,190728,145973,12683,16297,3081,3767,-27.1,0,125.68,163519,400602,-237083
2067-07,283416,12173,46052,14039,159238,237934,16803,30805,4676,587,24.33,0,138.08,295589,504871,-209282
2067-08,488288,11155,40377,7167,82464,212713,14952,31919,2509,551,136.67,1,94.37,499443,389592,109851
2067-09,182845,11234,45548,11806,103856,216429,21328,21749,2930,3693,58.1,1,103.4,194079,420716,-226637
2067-10,493673,27924,32319,10194,163821,162485,26790,17965,3110,2843,154.85,1,82.34,521597,413574,108023
2067-11,283569,48008,47495,7727,153703,135574,6754,8458,4315,3803,-18.77,0,138.96,331577,359711,-28134
2067-12,226008,48418,35026,7372,177561,64740,24229,25166,3575,2110,5.13,1,105.09,274426,334094,-59668
2068-01,272730,30081,23331,12534,94483,226922,28430,24601,3545,3103,11.7,0,114.42,302811,410301,-107490
2068-02,119455,20097,30784,7097,192238,171174,5910,7635,2762,2348,76.23,0,125.39,139552,414838,-275286
2068-03,414307,16185,39815,8952,121501,186619,25718,36104,4622,1023,118.11,1,124.55,430492,418709,11783
2068-04,445257,14740,34154,14437,106818,53018,13848,24630,1214,3517,310.84,1,85.38,459997,246905,213092
2068-05,334742,44969,35921,7534,180220,146357,23398,5175,1819,2449,299.5,0,106.07,379711,398605,-18894
2068-06,330617,43446,30576,7391,107247,106420,13420,18185,4085,3767,137.8,0,147.85,374063,283239,90824
2068-07,436050,48656,40328,8132,132709,171304,13072,16309,4453,1897,51.06,0,100.05,484706,381854,102852
2068-08,136938,37391,22448,13420,83877,163558,24912,30192,3577,1606,84.53,1,115.02,174329,338407,-164078
2068-09,143306,42812,30997,9029,189708,238634,5503,30066,1759,3444,98.49,1,119.04,186118,503937,-317819
2068-10,295627,33489,40974,10796,188253,190375,5341,31448,2427,1511,108.4,1,142.78,329116,467187,-138071
2068-11,114456,25596,41845,5865,148863,153426,28591,13086,597,1798,166.8,0,119.76,140052,391676,-251624
2068-12,499679,47765,37078,5857,164493,58580,20899,29815,4790,1512,74.63,1,133.73,547444,316722,230722
2069-01,144782,35454,33620,13239,176711,217656,28919,31073,4091,2741,14.92,0,100.06,180236,501218,-320982
2069-02,122551,12532,22260,6240,115396,209965,7046,13506,2171,756,135.79,0,86.39,135083,374413,-239330
2069-03,114046,34975,46940,7593,94785,225495,21837,6051,3897,3199,10.74,1,125.36,149021,402701,-253680
2069-04,266022,21718,25839,7612,88345,216088,6938,13401,2274,356,183.94,1,92.84,287740,358223,-70483
2069-05,167068,23779,45141,5649,179213,233317,12306,8119,788,1893,186.92,0,109.63,190847,483745,-292898
2069-06,274427,34493,34665,5021,111995,91955,20865,12969,515,300,561.36,0,88.14,308920,277470,31450
2069-07,342570,23789,36783,11874,84618,189544,27573,16236,1917,3358,147.6,0,103.51,366359,366628,-269
2069-08,169366,13908,47076,6348,177330,126287,26727,10947,2137,3184,82.74,1,127.39,183274,394715,-211441
2069-09,247765,47900,27437,9566,196671,249535,7153,23219,4325,2721,103.8,1,82.1,295665,513581,-217916
2069-10,257682,38567,40885,11965,115727,237131,14106,13434,1889,2446,209.53,1,88.28,296249,433248,-136999
2069-11,238044,19092,24352,8418,170415,132611,22597,33053,3461,2190,78.08,0,84.73,257136,391446,-134310
2069-12,412169,12721,38780,12867,169952,242769,20009,18450,1927,2641,145.97,1,133.57,424890,502827,-77937
2070-01,200265,43356,44834,10514,184503,133978,8372,30003,4097,2434,-7.97,0,118.96,243621,412204,-168583
2070-02,117930,29606,32945,12673,118987,244230,16526,21154,1634,2581,138.67,0,125.57,147536,446515,-298979
2070-03,151908,25306,47644,14777,103904,241866,26574,16335,1472,1722,187.77,1,146.14,177214,451100,-273886
2070-04,303519,46886,21249,13350,92958,235952,18776,35609,3832,3087,78.62,1,99.46,350405,417894,-67489
2070-05,314801,36036,22408,9309,194969,199476,7722,36349,1344,3413,220.62,0,136.67,350837,470233,-119396
2070-06,367720,48678,20502,8746,162123,205750,7850,20905,2207,3059,223.07,0,102.52,416398,425876,-9478
2070-07,145133,26276,30418,10565,128884,232875,13789,27754,1326,614,89.36,0,122.77,171409,444285,-272876
2070-08,178583,28575,33251,13336,171188,187179,14505,32282,1568,1762,103.41,1,140.97,207158,451741,-244583
2070-09,217114,15730,28701,10841,100634,79718,24942,14225,879,2968,334.55,1,92.83,232844,259061,-26217
2070-10,269371,42858,39321,7758,143679,128752,26392,20092,2239,393,146.75,1,144.67,312229,365994,-53765
2070-11,440659,22291,49876,10424,145194,64218,26461,30298,3332,2396,113.24,0,102.09,462950,326471,136479
2070-12,373249,35389,47431,12971,85692,83168,17797,29780,4536,2280,124.39,1,138.5,408638,276839,131799
2071-01,280095,48823,46306,13829,167587,131337,7052,8029,1418,2474,197.38,0,129.17,328918,374140,-45222
2071-02,283402,18202,38511,6707,168064,119438,17894,30906,2648,2227,50.19,0,99.88,301604,381520,-79916
2071-03,193382,34533,45691,10484,147401,212575,15994,26157,1068,855,138.18,1,141.71,227915,458302,-230387
2071-04,310833,49141,47770,13053,182823,126519,11470,6852,3657,923,107.95,1,140.95,359974,388487,-28513
2071-05,208439,48620,37568,9975,150577,83416,7658,32986,3310,764,91.17,0,112.03,257059,322180,-65121
2071-06,405965,37308,26576,14199,144850,230193,18336,37187,2484,3075,139.16,0,131.84,443273,471341,-28068
2071-07,406132,38591,33238,12604,136035,195767,23427,7001,634,1394,609.9,0,110.58,444723,408072,36651
2071-08,200686,26993,38985,8526,184951,56471,16521,30035,1281,821,155.49,1,103.09,227679,335489,-107810
2071-09,320851,17652,23740,8782,138222,247888,12669,13695,1850,3638,140.85,1,118.66,338503,444996,-106493
2071-10,109929,43080,26284,13900,182719,217891,15317,21477,3348,3464,89.57,1,105.81,153009,477588,-324579
2071-11,104599,11781,23592,5378,137162,96567,29530,38311,4686,2101,9.2,0,135.0,116380,330540,-214160
2071-12,467025,16289,44194,8564,82334,89617,23776,14197,2383,1777,212.6,1,102.21,483314,262682,220632
2072-01,475648,41757,36597,6819,103624,188503,5601,24933,1050,2321,514.53,0,138.32,517405,366077,151328
2072-02,428291,25102,26153,6777,80714,129222,16284,31292,3678,355,131.8,0,98.18,453393,290442,162951
2072-03,292343,16020,47470,12427,163552,77593,5287,37762,3108,316,113.59,1,111.24,308363,344091,-35728
2072-04,164959,36374,26420,7700,102972,201362,13841,34125,919,368,172.21,1,113.57,201333,386420,-185087
2072-05,166738,42387,28900,8333,159166,84958,11689,37882,3368,2839,24.25,0,127.51,209125,330928,-121803
2072-06,178468,37548,40322,6341,109615,83328,15064,18076,2083,1559,125.39,0,147.52,216016,272746,-56730
2072-07,405744,47432,41056,12715,136918,90341,14714,33015,4560,1241,214.54,0,112.73,453176,328759,124417
2072-08,485575,25728,30610,9721,123773,118672,27489,14316,3769,1628,112.16,1,90.51,511303,324581,186722
2072-09,486721,36310,22474,10535,196984,151115,11368,28356,4623,3573,119.84,1,144.29,523031,420832,102199
2072-10,204505,43378,33534,9860,191614,86111,16680,28675,1128,1307,157.06,1,146.15,247883,366474,-118591
2072-11,408112,32985,35012,13354,96994,198093,13335,36334,1864,3824,214.04,0,131.15,441097,393122,47975
2072-12,345813,20235,33918,11228,134477,222026,11989,28265,1715,2381,174.9,1,118.92,366048,441903,-75855
2073-01,280064,21584,28327,8172,85033,182469,14212,12345,2494,2152,126.86,0,133.77,301648,330558,-28910
2073-02,309406,44046,22026,7568,158475,141579,7600,15208,2990,3895,184.3,0,148.88,353452,352456,996
2073-03,431132,46578,49269,10786,172751,249581,21599,29886,818,2753,635.01,1,97.48,477710,533872,-56162
2073-04,483565,34089,25077,6372,156484,69215,16429,29769,1599,3227,243.03,1,84.38,517654,303346,214308
2073-05,344626,47573,21737,8541,107059,201359,25040,27167,1004,475,371.96,0,100.42,392199,390903,1296
2073-06,354509,41719,29373,9969,194738,158897,21174,32117,2873,597,85.28,0,91.42,396228,446268,-50040
2073-07,419706,38605,32584,7448,193327,224078,9164,19647,3982,697,158.37,0,109.15,458311,486248,-27937
2073-08,327990,40171,40087,14569,92282,188346,23957,31767,4837,3557,32.0,1,93.57,368161,391008,-22847
2073-09,114995,13437,48523,8905,158361,94465,12041,15661,2253,3943,27.97,1,149.36,128432,337956,-209524
2073-10,467650,14060,27191,8483,103356,246883,20534,34106,1158,1565,456.01,1,127.2,481710,440553,41157
2073-11,183922,38315,42966,11111,105278,105615,15975,27062,3428,875,47.55,0,119.78,222237,308007,-85770
2073-12,175825,15026,30082,10167,156205,169695,5990,31435,1022,2330,215.04,1,147.62,190851,403574,-212723
2074-01,490407,40849,40677,9266,134251,212552,11846,5744,4606,1196,41.75,0,112.5,531256,414336,116920
2074-02,481545,34593,26283,14355,99342,122125,20741,23509,3637,2160,165.03,0,129.26,516138,306355,209783
2074-03,110656,24188,29901,13248,126627,106748,8893,5745,3667,3201,-20.69,1,83.16,134844,291162,-156318
2074-04,378718,30527,31957,8189,182943,87147,14204,36251,519,904,798.2,1,86.73,409245,360691,48554
2074-05,465262,32719,48097,9910,179159,164876,13163,29347,2022,2732,251.32,0,131.1,497981,444552,53429
2074-06,257105,46803,29409,13283,89775,121245,10707,27713,2263,479,188.91,0,113.17,303908,292132,11776
2074-07,387470,29329,38798,8128,162512,82701,7785,26210,4959,1935,71.07,0,86.46,416799,326134,90665
2074-08,485483,11981,47408,8923,170712,209363,19420,7445,4603,2856,158.1,1,90.94,497464,463271,34193
2074-09,237952,25077,24529,12366,149786,204895,12431,19592,679,3155,346.4,1,100.12,263029,423599,-160570
2074-10,234969,43862,44396,11883,101299,166825,24278,25065,2847,2478,191.32,1,118.28,278831,373746,-94915
2074-11,462130,30474,34643,12507,156010,228323,23681,32942,1747,3181,253.26,0,84.3,492604,488106,4498
2074-12,405726,21446,35586,8568,107501,53437,9345,6371,2137,3015,187.82,1,125.43,427172,220808,206364
2075-01,253915,25680,31342,6380,185273,128252,14890,33099,1557,2095,209.74,0,133.17,279595,399236,-119641
2075-02,224267,26317,28322,9281,166426,86648,24725,13566,1454,515,247.91,0,111.88,250584,328968,-78384
2075-03,166310,39892,41524,11860,159328,160414,14115,14553,4418,787,156.33,1,147.15,206202,401794,-195592
2075-04,181523,27970,24338,13340,169531,247768,5964,30063,3484,1102,26.0,1,125.62,209493,491004,-281511
2075-05,487668,19439,23327,5354,116451,217905,7163,8038,1904,713,307.36,0,138.04,507107,378238,128869
2075-06,298170,46114,28513,14309,152109,104143,5374,36789,1599,3254,140.15,0,105.82,344284,341237,3047
2075-07,295010,46710,34068,13896,156526,99034,20620,39070,1294,2558,287.46,0,85.64,341720,363214,-21494
2075-08,420391,46666,38434,10955,169368,80134,21829,13000,4883,748,168.21,1,80.3,467057,333720,133337
2075-09,412441,36831,35617,12983,144442,83067,15177,22360,3769,3769,58.47,1,124.66,449272,313646,135626
2075-10,134916,18287,41034,12011,91565,55345,12167,10614,737,3529,223.88,1,92.47,153203,222736,-69533
2075-11,266723,11441,25113,11333,154342,249213,18757,11680,546,1209,615.19,0,118.92,278164,470438,-192274
2075-12,241614,15414,36751,5834,95694,105698,8094,26179,4303,1360,12.08,1,94.63,257028,278250,-21222
2076-01,232235,43342,25868,7829,179278,114226,15372,5699,3824,855,89.64,0,101.0,275577,348272,-72695
2076-02,262005,16997,30884,5946,144877,138311,17062,6770,3928,2465,61.35,0,129.55,279002,343850,-64848
2076-03,246860,41654,36250,12868,131203,177422,20990,34406,3375,3974,57.32,1,98.43,288514,413139,-124625
2076-04,233059,25845,27761,6209,173220,79336,7232,22750,4375,3401,109.6,1,121.87,258904,316508,-57604
2076-05,463839,33006,33397,12562,81125,227287,8014,35071,1519,1034,426.98,0,116.64,496845,397456,99389
2076-06,294694,19357,30532,7232,175929,135772,7634,30169,2517,1396,81.03,0,112.72,314051,387268,-73217
2076-07,201777,46737,23760,14359,186952,112121,20301,7360,4775,3227,103.42,0,81.12,248514,364853,-116339
2076-08,459853,38078,20480,13409,121884,56302,25859,32144,3279,3482,90.7,1,139.44,497931,270078,227853
2076-09,461889,43143,44074,12650,83490,170637,7136,16945,3071,3474,206.71,1,107.01,505032,334932,170100
2076-10,227792,32388,44053,5826,198579,228751,6692,22399,724,643,306.38,1,124.0,260180,506300,-246120
2076-11,279388,29675,21287,5767,191032,65717,19773,35165,3017,3371,147.29,0,135.74,309063,338741,-29678
2076-12,288875,10923,35578,13014,157991,117445,10250,24672,824,2789,377.33,1,107.5,299798,358950,-59152
2077-01,214889,31589,35079,10027,82694,125037,22117,35249,752,402,334.94,0,113.88,246478,310203,-63725
2077-02,390930,48523,29840,10700,195633,217586,25611,11811,931,1478,351.48,0,120.68,439453,491181,-51728
2077-03,324449,49041,29935,12802,84076,190550,29914,24841,3381,3573,132.04,1,135.21,373490,372118,1372
2077-04,468393,13302,42757,13400,153330,106226,10163,17304,3363,1886,198.83,1,131.3,481695,343180,138515
2077-05,287736,31199,27589,6623,186704,209778,24992,39876,721,2211,367.2,0,94.33,318935,495562,-176627
2077-06,350940,22971,49715,8671,128752,200768,29622,22032,1123,3684,360.1,0,145.52,373911,439560,-65649
2077-07,168146,26730,42904,10520,102943,243135,20966,27861,4565,2719,105.23,0,83.42,194876,448329,-253453
2077-08,285950,31178,40612,6936,176120,88256,9232,19116,1652,734,132.63,1,81.96,317128,340272,-23144
2077-09,485945,45845,35639,9973,155545,80748,20720,28392,1678,1918,312.06,1,119.63,531790,331017,200773
2077-10,198374,26600,31117,13845,104636,183223,14585,28878,1519,314,161.4,1,141.29,224974,376284,-151310
2077-11,307615,22838,47529,5749,130332,93769,16848,32779,851,343,342.54,0,149.53,330453,327006,3447
2077-12,222761,13129,37667,11750,97144,181018,29543,18602,4728,828,25.54,1,82.5,235890,375724,-139834
2078-01,499753,33132,36766,12366,181756,172488,21538,35502,1108,1718,479.13,0,118.28,532885,460416,72469
2078-02,344089,27713,49675,14845,170463,195058,7453,37367,3880,3532,131.58,0,86.1,371802,474861,-103059
2078-03,206570,19878,44725,11584,199441,213070,17022,15370,2705,3541,121.98,1,82.21,226448,501212,-274764
2078-04,312408,45950,33008,13979,175086,232590,26834,27570,1559,2662,172.16,1,148.21,358358,509067,-150709
2078-05,488209,18393,48240,14198,183946,74458,6104,36640,2521,1926,235.27,0,143.2,506602,363586,143016
2078-06,263983,24202,20927,12098,137386,102362,18924,13046,3654,3010,88.18,0,142.31,288185,304743,-16558
2078-07,162191,28358,21881,13323,90309,101305,8242,7455,2599,683,101.08,0,137.56,190549,242515,-51966
2078-08,199200,14331,34961,9568,131303,170136,12036,26550,2992,1814,28.38,1,146.67,213531,384554,-171023
2078-09,169738,22051,30624,11764,97350,185104,9314,33462,3981,3739,17.79,1,143.74,191789,367618,-175829
2078-10,466910,39674,38191,8920,90211,240318,16296,37164,1294,2185,358.99,1,143.12,506584,431100,75484
2078-11,270556,30273,22957,14257,81288,222485,5639,32189,577,2627,390.14,0,145.97,300829,378815,-77986
2078-12,152002,17553,31276,10208,103426,213971,8965,30729,2154,3160,58.81,1,118.44,169555,398575,-229020
2079-01,270450,45405,44608,12432,162700,86732,24992,7425,2998,652,26.43,0,145.44,315855,338889,-23034
2079-02,470603,18637,21262,8187,104809,149664,10314,19126,1104,3830,402.9,0,135.09,489240,313362,175878
2079-03,379841,13140,36959,14965,108809,134079,24363,36963,2255,3579,175.97,1,89.76,392981,356138,36843
2079-04,184941,40138,46855,8220,113483,65403,21702,26203,3221,1928,165.12,1,99.04,225079,281866,-56787
2079-05,421046,11846,23951,11661,163559,178090,10066,30082,1527,552,257.66,0,132.81,432892,417409,15483
2079-06,418402,36761,32499,11086,134046,107209,15109,22859,4995,1967,43.3,0,97.74,455163,322808,132355
2079-07,140159,15869,35417,9593,141159,71658,19494,34005,1544,3189,37.57,0,100.59,156028,311326,-155298
2079-08,340816,43336,32738,6292,128576,224681,21743,27506,4109,2281,43.58,1,97.91,384152,441536,-57384
2079-09,491394,20548,42874,14241,120303,199974,22121,6352,2057,1936,263.01,1,119.75,511942,405865,106077
2079-10,425578,40425,33952,5510,147352,193335,11389,23870,4679,1873,116.61,1,101.22,466003,415408,50595
2079-11,238410,49639,31410,11864,196220,79832,28465,22096,566,1536,376.05,0,130.43,288049,369887,-81838
2079-12,112004,12429,42792,14869,100690,229886,8480,10796,776,3021,204.15,1,149.26,124433,407513,-283080
2080-01,123800,13607,25314,12949,98938,63224,15540,11572,2314,651,-22.28,0,86.67,137407,227537,-90130
2080-02,342733,48824,28598,12081,116147,220555,20270,33850,534,1234,600.34,0,84.04,391557,431501,-39944
2080-03,254559,16294,23728,10297,113297,239403,28060,7806,2150,3302,173.02,1,123.2,270853,422591,-151738
2080-04,427463,44828,31582,10916,99189,240194,26470,32916,2007,1086,203.42,1,143.62,472291,441267,31024
2080-05,231245,32078,48509,13703,140280,178093,15735,7531,2753,1645,36.74,0,83.81,263323,403851,-140528
2080-06,147832,33169,31142,6405,113028,148436,9253,5450,4582,1846,63.37,0,118.8,181001,313714,-132713
2080-07,199964,32187,46796,5900,194275,156900,8383,18787,716,2945,185.92,0,98.46,232151,431041,-198890
2080-08,194945,43528,24132,5208,169578,110168,26974,34182,2578,3465,118.38,1,92.68,238473,370242,-131769
2080-09,201029,41269,45040,7346,104357,56105,18905,12511,1292,2016,209.78,1,131.29,242298,244264,-1966
2080-10,139942,30103,25538,7013,183015,147940,14665,10832,3049,919,76.0,1,87.34,170045,389003,-218958
2080-11,107538,15559,47823,8778,145619,153542,28769,24167,3469,3936,97.99,0,80.37,123097,408698,-285601
2080-12,372417,26613,31460,10563,99194,55724,23492,30723,2180,3969,130.75,1,100.73,399030,251156,147874
2081-01,294012,36022,25516,13878,138209,126158,8737,12817,4158,1508,87.26,0,138.64,330034,325315,4719
2081-02,103656,25393,35047,10921,137516,215996,20994,33916,1895,3528,-36.42,0,109.85,129049,454390,-325341
2081-03,461199,39248,44169,9240,142515,133589,14404,6084,650,1725,712.44,1,134.03,500447,350001,150446
2081-04,439986,15186,35694,6309,121497,242476,9724,6372,1046,3105,519.12,1,115.27,455172,422072,33100
2081-05,446060,49115,44466,10650,93775,100629,13465,39597,3320,1839,47.53,0,107.65,495175,302582,192593
2081-06,233038,17694,38003,10448,114151,121378,28161,28298,1062,2666,142.12,0,107.04,250732,340439,-89707
2081-07,140083,30981,30675,14664,110876,229796,27294,6021,1021,1006,239.66,0,143.45,171064,419326,-248262
2081-08,438653,16825,31085,6380,193053,151335,29496,24859,2700,2230,231.89,1,97.97,455478,436208,19270
2081-09,403340,13896,21840,7206,85234,101073,23419,32154,4165,3079,61.66,1,144.13,417236,270926,146310
2081-10,212392,10859,20387,13132,83863,114486,8308,5759,2590,2618,54.34,1,99.82,223251,245935,-22684
2081-11,395511,40361,25961,10386,87370,176686,10901,29132,1968,2271,176.65,0,99.32,435872,340436,95436
2081-12,403678,42522,26827,12338,186858,167140,7669,8226,4631,3045,104.33,1,112.04,446200,409058,37142
2082-01,455921,30193,20629,11126,187477,182022,9813,14721,3128,3835,150.86,0,114.48,486114,425788,60326
2082-02,272095,28367,34103,5486,176781,118313,7074,18397,4436,2950,113.43,0,148.69,300462,360154,-59692
2082-03,431652,43298,48758,12125,88294,117879,28359,9026,2772,2665,156.19,1,138.02,474950,304441,170509
2082-04,450595,34913,30573,10549,134733,209974,5749,36143,1858,848,309.46,1,95.17,485508,427721,57787
2082-05,232034,16501,41352,14665,132906,94868,6721,24145,2310,2924,82.44,0,111.26,248535,314657,-66122
2082-06,197654,31835,46789,11554,117853,96562,14570,22592,3922,2751,31.44,0,112.08,229489,309920,-80431
2082-07,115699,35574,33344,5349,197501,224597,29807,34304,4254,1861,104.51,0,117.58,151273,524902,-373629
2082-08,184448,42353,23224,8260,179151,208905,6914,38263,4553,2666,118.64,1,118.27,226801,464717,-237916
2082-09,351548,14291,25493,9821,149002,180348,19870,12243,3210,918,102.0,1,82.86,365839,396777,-30938
2082-10,127491,49706,25054,9202,174528,154880,14150,39879,1760,615,40.33,1,133.52,177197,417693,-240496
2082-11,371645,35908,30251,14613,93785,139837,27394,28602,718,2077,512.82,0,145.93,407553,334482,73071
2082-12,101921,42645,47675,8830,159295,62355,12891,33688,1060,2089,171.32,1,141.73,144566,324734,-180168
2083-01,102656,22385,45079,13820,96150,209234,23161,13082,3094,2339,38.99,0,137.77,125041,400526,-275485
2083-02,384808,18401,25774,8077,187598,75860,15711,36760,2375,3333,183.88,0,142.31,403209,349780,53429
2083-03,333487,32524,25191,14385,104960,130631,27784,6726,3051,1700,51.19,1,121.47,366011,309677,56334
2083-04,108927,16444,49481,10291,147509,130602,26923,15041,4124,1044,-65.39,1,114.01,125371,379847,-254476
2083-05,192830,11718,28530,8089,86067,180118,26119,35742,3750,1011,21.33,0,82.7,204548,364665,-160117
2083-06,163982,11932,22947,11446,169230,145199,11551,33055,1752,2323,101.04,0,119.37,175914,393428,-217514
2083-07,357031,23908,42166,8724,189874,169637,15721,9909,4383,3035,58.67,0,116.38,380939,436031,-55092
2083-08,181151,27909,22912,6998,143481,155866,11230,20742,2849,2344,65.07,1,106.39,209060,361229,-152169
2083-09,258466,11457,33506,13959,198265,175739,25627,10462,909,2491,291.32,1,132.09,269923,457558,-187635
2083-10,246742,12551,26474,6623,198276,121118,9773,10334,1768,2122,108.03,1,99.08,259293,372598,-113305
2083-11,249422,44328,46124,12230,107612,137943,27409,36347,2626,2209,103.44,0,84.17,293750,367665,-73915
2083-12,314803,47657,20374,13349,138505,62143,23015,7177,4786,1497,42.3,1,108.07,362460,264563,97897
2084-01,246953,13406,40038,8272,106337,210297,12729,16889,2957,1613,107.95,0,95.19,260359,394562,-134203
2084-02,339335,10579,34230,11246,164933,83228,29869,39004,3917,3769,114.54,0,93.8,349914,362510,-12596
2084-03,477116,20527,35994,9804,111184,135887,29622,12953,2622,2717,137.38,1,140.52,497643,335444,162199
2084-04,169614,13885,31642,6364,159206,211045,26067,28119,3630,821,-45.12,1,106.04,183499,462443,-278944
2084-05,165434,47880,33950,8344,85076,171073,5493,32804,4602,3692,-6.57,0,145.65,213314,336740,-123426
2084-06,154484,42585,34707,12825,151524,231375,19448,24388,3575,3215,62.93,0,148.04,197069,474267,-277198
2084-07,232207,19878,33949,14252,96352,227521,17090,21516,4103,3308,52.4,0,121.67,252085,410680,-158595
2084-08,407631,13295,41414,7581,181939,173493,7798,18420,737,1634,510.67,1,119.43,420926,430645,-9719
2084-09,269774,15057,28354,10933,134212,53609,22598,20805,2549,1421,13.63,1,136.21,284831,270511,14320
2084-10,287574,24546,24938,10960,137847,215390,19888,28606,4582,1537,16.28,1,112.81,312120,437629,-125509
2084-11,326132,20375,31489,13734,186202,237766,16795,9915,678,1301,486.04,0,134.02,346507,495901,-149394
2084-12,486359,21128,36907,7918,137906,216632,20528,22060,2685,3910,264.67,1,122.84,507487,441951,65536
2085-01,115596,44353,39590,6664,190153,112371,10607,10245,808,342,169.61,0,104.19,159949,369630,-209681
2085-02,177250,26767,30135,12717,148114,88385,18286,31280,3787,3509,68.35,0,131.09,204017,328917,-124900
2085-03,174883,35053,49845,8192,147779,196611,15519,30164,1513,2861,112.09,1,143.9,209936,448110,-238174
2085-04,146636,41807,25078,13658,168993,165905,26594,14832,3704,1112,23.82,1,134.91,188443,415060,-226617
2085-05,404434,36396,31317,10390,151824,67844,12052,29991,4636,2696,-32.03,0,135.07,440830,303418,137412
2085-06,224222,29649,40619,10554,168943,192566,22684,16743,1519,2305,145.3,0,147.82,253871,452109,-198238
2085-07,188082,35232,33376,14530,159537,79738,28493,28952,2338,1886,1.12,0,138.03,223314,344626,-121312
2085-08,484174,47077,42350,8508,86174,107467,20788,23874,3891,892,193.3,1,118.06,531251,289161,242090
2085-09,348784,47039,47582,10976,80469,65605,10484,26505,1454,3966,297.57,1,129.92,395823,241621,154202
2085-10,422668,31849,41434,14871,114142,134402,27200,27876,2276,3560,185.12,1,98.09,454517,359925,94592
2085-11,357719,42416,42800,8685,82336,126113,9471,15384,4577,3354,118.59,0,85.36,400135,284789,115346
2085-12,145888,33236,25347,8470,115734,62870,25262,14335,4116,2217,-6.68,1,99.19,179124,252018,-72894
2086-01,370028,18856,43755,13238,117667,129633,15016,22205,4411,2645,60.12,0,134.55,388884,341514,47370
2086-02,423270,44950,32201,14477,97193,224706,19337,25366,3854,2592,122.39,0,142.97,468220,413280,54940
2086-03,361551,11472,28417,8119,103544,137377,25810,28759,1967,3758,167.41,1,132.6,373023,332026,40997
2086-04,304359,23041,38855,8030,138635,128531,25024,34059,1483,3456,214.58,1,92.67,327400,373134,-45734
2086-05,236748,21276,48585,11663,140550,151748,29239,32716,2307,2496,76.02,0,109.38,258024,414501,-156477
2086-06,101319,40492,37707,11282,93482,240406,20782,18554,1243,382,89.41,0,96.25,141811,422213,-280402
2086-07,124084,27995,27588,11155,182909,164055,10078,8779,1708,1648,41.78,0,144.05,152079,404564,-252485
2086-08,266308,37619,37231,7417,175033,58976,9672,31567,2904,1590,31.19,1,88.94,303927,319896,-15969
2086-09,247718,26989,20519,6902,96705,150545,25473,23007,3320,2569,94.6,1,137.21,274707,323151,-48444
2086-10,496700,45273,40763,12905,151529,212858,6053,5974,1132,2918,549.33,1,121.26,541973,430082,111891
2086-11,186785,19983,20314,9638,163059,218523,29630,30975,2203,3501,105.99,0,100.25,206768,472139,-265371
2086-12,328629,25248,33326,7457,154670,248257,13910,31497,1462,1768,306.7,1,131.85,353877,489117,-135240
2087-01,110596,47393,38467,11409,135405,156806,6061,12207,2282,1016,62.08,0,120.63,157989,360355,-202366
2087-02,246626,11222,22864,13516,181989,69670,20521,28443,519,2341,371.65,0,85.86,257848,337003,-79155
2087-03,189507,47771,47510,8465,132708,50510,23923,14335,4255,800,-4.79,1,101.13,237278,277451,-40173
2087-04,427966,37212,28689,8472,106679,118253,5003,24123,3568,2925,91.36,1,137.47,465178,291219,173959
2087-05,172365,20841,20017,14185,181870,211086,22993,16731,2791,1995,85.28,0,90.39,193206,466882,-273676
2087-06,474185,18482,48441,5271,113640,128961,12562,33227,3310,1823,115.93,0,92.43,492667,342102,150565
2087-07,364823,27912,43078,11871,135559,237760,7593,31817,1572,1478,258.92,0,94.82,392735,467678,-74943
2087-08,464765,23809,34995,9770,153213,132060,6865,26802,991,2702,497.65,1,87.44,488574,363705,124869
2087-09,432039,16740,31407,8487,157931,126841,23702,15034,1508,2220,275.12,1,114.09,448779,363402,85377
2087-10,405140,22994,29688,13034,196866,61609,16056,36043,4432,3711,146.69,1,116.6,428134,353296,74838
2087-11,286581,43010,26816,10444,157396,228672,24647,30141,3932,1435,23.2,0,134.39,329591,478116,-148525
2087-12,259815,33923,42342,13767,163481,184947,29416,24670,853,2341,348.55,1,108.16,293738,458623,-164885
2088-01,132372,21045,32947,7276,189889,131884,7964,14246,3570,3204,70.72,0,115.09,153417,384206,-230789
2088-02,461601,36225,34343,13585,180374,117725,28182,22232,3545,3533,181.4,0,88.79,497826,396441,101385
2088-03,168747,18430,24011,14494,177156,231206,29786,18703,984,1776,117.87,1,92.62,187177,495356,-308179
2088-04,400345,31155,33028,6549,150388,69616,6934,15008,4531,3985,28.5,1,95.63,431500,281523,149977
2088-05,407347,31097,36663,13186,159350,114759,22591,11173,4395,1307,92.07,0,121.21,438444,357722,80722
2088-06,139534,27417,33587,6202,150164,134386,12808,9231,4058,2271,95.61,0,82.0,166951,346378,-179427
2088-07,390721,26711,44972,8679,93960,136122,16051,18370,736,3779,494.76,0,105.77,417432,318154,99278
2088-08,338790,26175,25033,10738,198681,55896,29466,33014,3575,1889,81.47,1,87.8,364965,352828,12137
2088-09,279779,48116,44150,12692,160020,176981,21071,29016,4636,3964,39.91,1,134.58,327895,443930,-116035
2088-10,275387,35077,24737,12786,96646,50849,12739,9009,2981,2503,41.76,1,98.23,310464,206766,103698
2088-11,487823,35494,44030,6151,95398,92122,16569,16207,1267,3190,311.55,0,124.27,523317,270477,252840
2088-12,232971,24315,29707,11109,194150,88133,10283,33363,2107,1871,78.24,1,99.05,257286,366745,-109459
2089-01,258640,49659,46075,13598,83795,130562,8264,7725,3907,868,32.13,0,81.94,308299,290019,18280
2089-02,373876,32510,45609,5341,172438,92131,11353,8044,987,2542,364.79,0,115.02,406386,334916,71470
2089-03,428075,20258,43658,11808,130504,178499,22914,8892,3014,3590,186.34,1,82.83,448333,396275,52058
2089-04,237811,21185,45472,10495,102820,169964,16432,19918,3182,3058,163.61,1,98.74,258996,365101,-106105
2089-05,298761,10630,49780,11317,122490,148151,19274,19657,3902,3838,105.44,0,83.04,309391,370669,-61278
2089-06,343995,25772,42115,7470,149719,147894,12136,20973,1412,1816,152.44,0,124.79,369767,380307,-10540
2089-07,413090,28697,32982,9750,156285,114498,13382,17190,3516,2640,14.69,0,144.65,441787,344087,97700
2089-08,391655,37082,21847,11024,116976,103128,9097,28702,2996,1604,125.36,1,84.26,428737,290774,137963
2089-09,495779,22451,46772,7425,152630,82944,25187,20061,2993,2219,124.86,1,95.4,518230,335019,183211
2089-10,146482,14843,36373,10295,191728,123104,27324,32352,2847,907,136.39,1,91.03,161325,421176,-259851
2089-11,302643,27428,45471,10030,148184,218527,29184,37576,1326,1286,241.17,0,118.59,330071,488972,-158901
2089-12,456460,35705,42266,11031,145855,195322,8213,15851,3123,799,-13.15,1,116.88,492165,418538,73627
2090-01,157577,15192,48302,10236,80528,144766,28684,16884,3142,1469,114.55,0,112.82,172769,329400,-156631
2090-02,352631,39906,41632,5130,122959,158992,9570,37684,1703,1416,177.84,0,99.54,392537,375967,16570
2090-03,316778,39718,24152,6435,90994,160137,12255,13353,3297,2747,9.24,1,118.0,356496,307326,49170
2090-04,465380,46354,43997,5042,106605,81769,26004,35155,1018,2846,421.97,1,108.43,511734,298572,213162
2090-05,450424,24389,27114,11121,81051,197609,29081,31309,3707,501,164.87,0,100.53,474813,377285,97528
2090-06,462980,49389,46658,9484,191825,74177,18761,11488,3716,1570,169.18,0,131.8,512369,352393,159976
2090-07,449007,28067,45382,7982,131021,155002,18694,5458,1058,1053,469.21,0,133.34,477074,363539,113535
2090-08,449768,41461,36659,9935,135680,152783,8030,6403,1901,1372,208.2,1,140.61,491229,349490,141739
2090-09,469434,20170,27654,12724,197124,195369,6207,35398,1787,2049,315.89,1,103.29,489604,474476,15128
2090-10,205777,10351,49593,7873,86743,60739,26376,26130,3002,2222,121.87,1,143.25,216128,257454,-41326
2090-11,378523,35611,49597,11410,178386,212586,25809,28396,3292,3510,168.15,0,85.0,414134,506184,-92050
2090-12,198081,13100,43508,11178,111956,199896,29800,11424,1760,3643,124.29,1,95.21,211181,407762,-196581
2091-01,441841,47179,29308,12397,171922,51488,5453,5557,4821,882,162.4,0,104.17,489020,276125,212895
2091-02,127824,14601,34435,7687,144485,113249,26421,31261,2934,3974,80.03,0,82.17,142425,357538,-215113
2091-03,311834,44458,36577,10428,156337,173686,24489,26633,4171,566,224.97,1,104.43,356292,428150,-71858
2091-04,396304,15134,42474,5823,137002,98876,10395,5525,2355,1230,185.94,1,92.91,411438,300095,111343
2091-05,204037,13455,30642,6389,194244,198568,15030,8358,4440,3540,27.17,0,145.54,217492,453231,-235739
2091-06,207475,36176,43100,8873,183915,148689,6162,5187,2605,2898,76.29,0,81.64,243651,395926,-152275
2091-07,151264,45856,25375,10367,164538,224834,27106,29456,3434,1162,10.53,0,149.9,197120,481676,-284556
2091-08,377498,15718,40197,8059,173384,215615,5038,26781,957,1936,476.27,1,99.72,393216,469074,-75858
2091-09,253057,40683,26360,13152,135773,107638,23514,9536,548,3757,454.18,1,140.26,293740,315973,-22233
2091-10,441389,27826,23122,14000,147058,97011,21504,22012,4859,2585,56.7,1,114.32,469215,324707,144508
2091-11,455894,14648,49228,11635,158134,54344,8334,34196,2957,1275,153.88,0,129.84,470542,315871,154671
2091-12,335170,35065,30758,6164,100495,196953,29535,32792,2316,2007,163.72,1,130.45,370235,396697,-26462
2092-01,147378,14965,21912,6122,189710,77746,5921,14075,2034,3477,147.0,0,84.27,162343,315486,-153143
2092-02,184218,17651,28124,9082,123724,232550,7494,22875,1183,3034,182.01,0,123.43,201869,423849,-221980
2092-03,435020,17906,48982,13839,124276,160141,19301,17765,3401,2168,152.28,1,114.74,452926,384304,68622
2092-04,424128,36208,40532,14093,164709,182827,15148,34701,2479,1475,167.66,1,97.19,460336,452010,8326
2092-05,437481,18135,49406,13700,120451,126170,7984,37105,3559,2182,69.7,0,103.12,455616,354816,100800
2092-06,264833,25301,21562,7225,97393,124276,11358,25390,1212,1208,268.49,0,96.85,290134,287204,2930
2092-07,241090,27185,44012,11744,116464,198413,8981,5441,3418,2340,156.97,0,88.56,268275,385055,-116780
2092-08,457635,20050,28484,13294,135574,65657,6902,24735,4883,3834,14.89,1,94.13,477685,274646,203039
2092-09,321840,34294,23691,6998,139819,153316,21197,11077,3958,2457,131.55,1,105.65,356134,356098,36
2092-10,399276,41430,47216,5652,101973,189230,7315,39943,2789,1689,144.05,1,83.22,440706,391329,49377
2092-11,420759,22221,41113,13451,103827,137140,24889,33980,3822,1675,90.91,0,101.75,442980,354400,88580
2092-12,108227,12201,41245,14282,156530,108197,10888,18610,3622,322,6.3,1,100.92,120428,349752,-229324
2093-01,168038,41156,42626,6228,106473,186942,6577,27628,3293,3814,31.7,0,137.48,209194,376474,-167280
2093-02,303879,17517,41441,14064,171298,87719,10624,39769,4285,3233,19.22,0,97.24,321396,364915,-43519
2093-03,365246,25045,29583,9259,90975,147769,5436,13496,2007,2750,269.31,1,117.78,390291,296518,93773
2093-04,347267,48408,47127,5838,115379,240673,13274,26657,2380,1650,90.73,1,106.1,395675,448948,-53273
