Month-Year,Sales Revenue (₹),Service Fees (₹),Rent (₹),Utilities (₹),Salaries & Wages (₹),Raw Materials / Inventory (₹),Transportation / Logistics (₹),Loan Repayments & Interest (₹),Number of Orders,Customers,Average Order Value,Seasonality_Flag,Fuel Price Index,Total Income (₹),Total Expenses (₹),Net Cash Flow (₹)
2010-01,404344,39647,41056,6974,187597,80442,24820,35943,3319,2970,119.22,0,116.94,443991,376832,67159
2010-02,229800,23070,47087,5676,99728,190456,10962,33260,2659,3759,65.25,0,127.39,252870,387169,-134299
2010-03,311246,16966,21210,11004,158436,186049,8898,26051,4572,2547,110.47,1,91.14,328212,411648,-83436
2010-04,130081,24014,48779,10360,165802,225141,17683,20933,2330,2339,57.2,1,120.06,154095,488698,-334603
2010-05,455187,30362,39775,9725,93776,154901,22918,7812,1617,3665,199.93,0,81.59,485549,328907,156642
2010-06,325137,17097,39479,7397,156250,200081,21104,10005,2600,3744,93.49,0,140.61,342234,434316,-92082
2010-07,129387,11244,43167,8727,140195,198917,26416,10690,3555,1100,60.56,0,137.61,140631,428112,-287481
2010-08,489893,21416,43663,12226,186850,54470,23973,36729,1668,784,202.47,1,114.15,511309,357911,153398
2010-09,169281,17829,24470,9030,132524,174544,20396,22889,3618,2011,144.02,1,144.15,187110,383853,-196743
2010-10,178350,48588,23239,10432,127134,151040,25553,15623,3068,2824,124.4,1,149.22,226938,353021,-126083
2010-11,364911,42763,39150,8370,126655,101436,19968,31432,2961,2581,194.27,0,134.61,407674,327011,80663
2010-12,432136,19710,41874,10975,197283,243082,16065,38319,4995,1008,116.04,1,126.93,451846,547598,-95752
2011-01,270405,46909,45352,13808,121664,210501,23158,16614,609,3578,460.96,0,82.86,317314,431097,-113783
2011-02,466325,38931,24167,5187,131541,168854,9419,8843,4971,510,47.2,0,85.0,505256,348011,157245
2011-03,419111,10764,26813,9084,145746,225976,15288,24746,1642,3947,230.79,1,129.57,429875,447653,-17778
2011-04,471222,48138,23589,5103,145865,122262,20525,22815,1519,2739,259.53,1,145.41,519360,340159,179201
2011-05,474013,22958,37311,11159,134683,225323,24593,32450,3093,1554,62.76,0,88.01,496971,465519,31452
2011-06,384712,12293,27067,14759,159579,76865,11140,37784,4680,3900,77.23,0,121.14,397005,327194,69811
2011-07,167301,23811,39333,9944,173463,206656,15255,30513,1454,1647,173.02,0,116.04,191112,475164,-284052
2011-08,382191,35628,45437,11898,195820,92272,23428,25261,1633,3478,286.52,1,149.49,417819,394116,23703
2011-09,368314,24324,36946,8098,89485,83550,12632,21806,4688,2322,125.44,1,128.98,392638,252517,140121
2011-10,436669,24613,28171,7917,156447,57743,10353,37590,3857,3430,169.89,1,93.87,461282,298221,163061
2011-11,140601,28507,27805,8113,145121,136804,15719,8458,2175,1400,68.16,0,134.79,169108,342020,-172912
2011-12,401955,37504,30768,10423,109810,219234,23305,6441,1856,1308,147.34,1,119.18,439459,399981,39478
2012-01,177470,43875,33467,6519,182410,130055,25241,5243,2541,2846,21.2,0,135.77,221345,382935,-161590
2012-02,268671,23646,26852,11394,113831,131164,8297,15442,3620,2107,109.45,0,120.15,292317,306980,-14663
2012-03,249213,20328,49945,8176,139705,189861,6528,19213,1698,2836,129.26,1,120.49,269541,413428,-143887
2012-04,236104,30883,26306,9043,192121,161103,8834,21937,1186,1734,164.05,1,139.85,266987,419344,-152357
2012-05,232154,33660,47619,6189,183852,145391,17884,9011,3230,673,15.37,0,97.7,265814,409946,-144132
2012-06,340324,43587,20545,14411,136853,177283,10882,22670,3176,2330,104.95,0,119.41,383911,382644,1267
2012-07,343614,29069,36428,11040,121359,54127,18732,23075,4727,1915,23.51,0,90.49,372683,264761,107922
2012-08,230608,16115,35664,5814,96227,165527,9702,33911,4926,3953,142.86,1,81.34,246723,346845,-100122
2012-09,174177,36891,28665,8803,96512,95748,26343,5003,1807,1444,101.44,1,112.24,211068,261074,-50006
2012-10,284717,31647,37999,12885,164547,142015,21896,37495,3091,3856,134.13,1,134.81,316364,416837,-100473
2012-11,488880,33267,42553,11208,115356,242583,29685,27984,2917,3554,45.57,0,80.52,522147,469369,52778
2012-12,285596,39731,24690,8173,94712,243280,17510,29432,3528,2986,111.04,1,94.76,325327,417797,-92470
2013-01,182106,46117,25478,6331,179333,224353,21543,6436,4668,2246,31.38,0,115.75,228223,463474,-235251
2013-02,203582,10311,43672,7867,165462,188229,7263,28802,2480,3871,162.17,0,147.16,213893,441295,-227402
2013-03,374703,47875,45182,5725,112448,124458,22639,28413,3720,3477,76.16,1,119.3,422578,338865,83713
2013-04,427197,21829,40635,8120,135921,52740,28552,21553,4607,679,8.39,1,85.45,449026,287521,161505
2013-05,388136,10953,22863,9412,128417,202226,11254,35961,1498,2939,315.25,0,103.55,399089,410133,-11044
2013-06,204303,13581,35780,10220,141971,103088,6214,12758,3879,3891,3.22,0,139.97,217884,310031,-92147
2013-07,236967,29210,35034,11481,131634,131110,7303,11854,4048,2768,26.64,0,132.59,266177,328416,-62239
2013-08,450759,10310,47386,10004,144725,187967,27961,13187,3606,2222,53.22,1,111.0,461069,431230,29839
2013-09,231615,13060,39566,12054,88119,168355,16500,17609,4055,994,45.77,1,119.82,244675,342203,-97528
2013-10,458741,47402,25185,13681,82021,223403,12148,28105,4689,1166,126.65,1,121.91,506143,384543,121600
2013-11,180853,27692,26813,8490,156405,141667,16314,39291,2947,1780,122.98,0,133.11,208545,388980,-180435
2013-12,257505,23488,29199,6089,154923,196864,10640,25952,3905,2634,93.96,1,127.52,280993,423667,-142674
2014-01,435056,28412,47426,5746,126305,186866,10222,31651,4484,520,184.76,0,88.13,463468,408216,55252
2014-02,216022,43499,39058,8310,129670,51609,18827,33365,2287,633,82.27,0,114.33,259521,280839,-21318
2014-03,221612,27376,34193,5270,197605,176348,21800,22993,1866,3169,30.82,1,140.55,248988,458209,-209221
2014-04,267368,12155,48650,10690,181205,123280,23590,11235,3774,3246,105.48,1,102.38,279523,398650,-119127
2014-05,144457,16500,44559,14987,183736,224234,17241,17766,2765,425,52.27,0,108.96,160957,502523,-341566
2014-06,180820,29951,42284,8929,123681,84110,6821,7696,2164,600,95.56,0,127.26,210771,273521,-62750
2014-07,183248,49237,36930,9651,166796,105551,6740,36830,4969,2184,3.82,0,81.72,232485,362498,-130013
2014-08,201330,37581,30963,12242,120556,216214,21921,34131,4322,3901,-12.96,1,114.67,238911,436027,-197116
2014-09,474327,35708,38460,7233,80337,117725,14035,21137,1810,2208,295.28,1,94.17,510035,278927,231108
2014-10,190023,39589,43307,14326,112506,140303,28762,13966,1718,1536,149.97,1,109.89,229612,353170,-123558
2014-11,299257,37102,28634,13622,116169,128061,11683,32845,3885,1290,87.11,0,104.55,336359,331014,5345
2014-12,455722,35110,26008,13312,95412,203650,27189,14509,4732,3008,68.76,1,146.39,490832,380080,110752
2015-01,499727,25868,36148,5114,191519,95801,5438,7487,4648,662,124.35,0,146.59,525595,341507,184088
2015-02,380645,34195,47809,5592,95509,225557,5999,5656,4285,991,59.91,0,115.85,414840,386122,28718
2015-03,221586,29116,21910,8279,87989,180339,18939,39587,2275,3124,175.01,1,86.04,250702,357043,-106341
2015-04,117609,18434,27833,8989,86657,107107,8299,18655,4829,3125,2.11,1,125.05,136043,257540,-121497
2015-05,308007,47739,39100,6533,199954,181126,8679,16575,3631,2464,137.58,0,119.52,355746,451967,-96221
2015-06,391119,49520,42520,9767,118152,226297,22421,35994,4189,3421,163.42,0,84.65,440639,455151,-14512
2015-07,352804,16435,20208,6910,156620,72629,6050,7369,1328,1360,237.73,0,113.39,369239,269786,99453
2015-08,392102,45480,35866,9399,97890,210157,26684,21214,3087,2055,97.87,1,139.64,437582,401210,36372
2015-09,207664,30303,49146,14225,176097,141772,19727,30976,3807,3638,97.98,1,109.6,237967,431943,-193976
2015-10,311304,34918,35449,11334,81879,50083,19198,10369,4628,3232,92.21,1,87.37,346222,208312,137910
2015-11,492310,44716,48574,13785,150247,131441,28659,13114,2317,749,131.29,0,147.94,537026,385820,151206
2015-12,471750,35862,27994,9263,82190,201982,25882,17989,2710,3314,253.33,1,95.27,507612,365300,142312
2016-01,174499,27355,32734,14259,141477,120230,27403,23106,1779,1541,90.54,0,117.15,201854,359209,-157355
2016-02,388422,12115,35040,10340,107495,166212,18297,25859,3726,3641,137.76,0,97.01,400537,363243,37294
2016-03,417929,14462,25262,13586,100064,109066,25336,19366,3388,1804,159.1,1,116.71,432391,292680,139711
2016-04,122300,34476,22745,6857,197877,87431,20386,24197,1794,2179,71.77,1,89.91,156776,359493,-202717
2016-05,165039,46678,45667,8296,194713,176569,22842,11784,3228,1355,105.19,0,140.66,211717,459871,-248154
2016-06,199880,18431,35541,11064,162549,94873,23022,6494,1057,3964,197.51,0,123.45,218311,333543,-115232
2016-07,226649,48178,28044,14944,136159,86511,12336,30145,4546,580,2.03,0,87.86,274827,308139,-33312
2016-08,336494,40403,26853,12525,168565,182472,22350,23452,820,861,425.61,1,148.19,376897,436217,-59320
2016-09,489052,37928,38735,6091,162784,181368,12621,25270,3361,1345,182.38,1,121.56,526980,426869,100111
2016-10,252170,43731,35408,12840,115384,110059,8019,25161,4478,3188,-15.27,1,130.48,295901,306871,-10970
2016-11,494000,43203,27298,8478,126684,74737,10217,8130,880,3329,481.99,0,98.66,537203,255544,281659
2016-12,486549,19915,38399,10877,184502,131183,16266,32329,2838,488,140.16,1,141.88,506464,413556,92908
2017-01,317473,28899,34663,6114,162001,63210,15607,25297,3407,1196,86.88,0,115.13,346372,306892,39480
2017-02,472971,34753,23031,12226,188615,64595,26395,15813,3943,3689,26.07,0,143.47,507724,330675,177049
2017-03,142653,42485,39905,13864,147229,183289,17135,36374,3583,3576,38.07,1,126.84,185138,437796,-252658
2017-04,317724,44365,26848,6803,157452,245817,16758,6410,1659,3727,268.9,1,93.84,362089,460088,-97999
2017-05,292518,39689,24660,10538,126042,140140,16041,33892,1438,1431,176.29,0,124.52,332207,351313,-19106
2017-06,248373,43705,27001,6431,93322,199969,25668,32497,2034,1228,195.68,0,122.29,292078,384888,-92810
2017-07,120780,22385,28494,11904,98450,238458,25566,11208,4665,2179,4.65,0,102.31,143165,414080,-270915
2017-08,380987,48072,30610,12237,87262,224620,25885,23804,2088,967,290.73,1,122.61,429059,404418,24641
2017-09,460987,41728,40526,5645,83625,104677,21946,22785,3667,1502,112.58,1,86.87,502715,279204,223511
2017-10,377970,30656,27067,12015,100086,210087,13117,37790,2126,2974,148.66,1,146.27,408626,400162,8464
2017-11,478878,33955,45958,10246,107456,77121,28878,22243,4966,1766,120.13,0,88.54,512833,291902,220931
2017-12,335483,43476,34128,6630,184720,228767,5238,31282,1625,1263,210.24,1,109.26,378959,490765,-111806
2018-01,452392,18055,38149,9969,157624,238635,13609,27140,1696,558,321.83,0,82.46,470447,485126,-14679
2018-02,295858,39417,40715,5196,132944,143615,19100,30096,2937,2692,28.24,0,99.72,335275,371666,-36391
2018-03,318761,35810,27420,7286,192996,137091,25155,29727,1779,3091,154.62,1,139.37,354571,419675,-65104
2018-04,409831,22898,20063,5746,128950,240786,14910,18312,1849,2171,281.02,1,93.66,432729,428767,3962
2018-05,421738,24804,38461,6174,153581,233157,22064,25233,3302,1809,73.49,0,121.82,446542,478670,-32128
2018-06,330172,47453,29095,8565,190850,188917,17248,14380,3476,3439,178.87,0,130.73,377625,449055,-71430
2018-07,400742,49908,20986,10615,126456,77462,26579,39775,824,965,428.67,0,87.36,450650,301873,148777
2018-08,277819,26300,25239,11209,147372,58051,29712,9779,1577,1918,185.25,1,105.76,304119,281362,22757
2018-09,341308,31289,39884,9106,181432,217892,16256,5221,3348,3346,124.12,1,141.34,372597,469791,-97194
2018-10,149415,26895,21765,10147,148386,91862,14197,26557,4826,1094,55.94,1,137.19,176310,312914,-136604
2018-11,134766,41768,34361,12306,82497,220616,10837,37313,4744,1324,70.38,0,141.05,176534,397930,-221396
2018-12,105520,24446,32585,6499,136569,50285,6526,6675,2077,2703,-1.64,1,123.21,129966,239139,-109173
2019-01,246924,11733,45307,6347,133451,238066,13119,22010,4238,1545,37.35,0,120.15,258657,458300,-199643
2019-02,248606,13231,36367,13377,164867,68197,14379,24832,2622,1187,56.87,0,122.28,261837,322019,-60182
2019-03,227941,41625,23120,5458,182488,197819,7035,14465,1309,3098,174.64,1,145.97,269566,430385,-160819
2019-04,281751,37584,44802,11731,101370,245871,17712,28254,4253,2372,106.72,1,84.11,319335,449740,-130405
2019-05,309759,48704,39492,8014,163086,130997,28532,36868,4885,3745,41.03,0,99.95,358463,406989,-48526
2019-06,126933,19182,46470,9851,95329,82009,21482,12311,1913,2078,21.08,0,114.59,146115,267452,-121337
2019-07,246327,19238,41147,13375,107282,128840,14402,21683,564,362,359.77,0,128.71,265565,326729,-61164
2019-08,433388,44584,35126,11583,124386,163110,9094,33127,4176,404,-14.14,1,142.35,477972,376426,101546
2019-09,236542,10308,45540,9069,97768,70511,10582,27750,2351,398,113.48,1,140.54,246850,261220,-14370
2019-10,400507,29081,33360,12750,84224,170740,18325,10449,1466,425,326.19,1,96.1,429588,329848,99740
2019-11,230244,28928,46891,12010,89178,213808,29003,23025,1935,597,136.1,0,116.43,259172,413915,-154743
2019-12,330578,46181,47426,12211,117402,128853,10094,24012,3823,3035,84.31,1,102.81,376759,339998,36761
2020-01,251805,39352,49345,12809,169695,83463,7053,9445,3306,1891,89.68,0,130.06,291157,331810,-40653
2020-02,490369,22370,29301,8866,153840,214953,26982,15100,3202,1880,174.61,0,138.76,512739,449042,63697
2020-03,422919,37415,49542,11058,179056,129303,22837,35962,3573,3423,162.16,1,94.7,460334,427758,32576
2020-04,348193,22707,29759,12792,144539,60444,19004,27860,4628,3844,94.39,1,89.0,370900,294398,76502
2020-05,348492,23227,23575,12896,132860,191403,14630,37716,1520,2880,229.75,0,112.63,371719,413080,-41361
2020-06,222693,14642,34501,8749,162987,163443,26627,39681,1417,2906,160.96,0,122.99,237335,435988,-198653
2020-07,157291,38707,29285,8897,105490,245003,25217,12552,4276,2725,-38.21,0,149.12,195998,426444,-230446
2020-08,118043,25694,46244,5242,131335,98340,19400,6802,1112,2280,-26.84,1,94.24,143737,307363,-163626
2020-09,284565,12650,24108,10768,107286,185557,16067,6866,4213,510,75.17,1,130.32,297215,350652,-53437
2020-10,495816,27093,31960,14409,119112,187048,24889,23695,2754,1194,201.96,1,142.52,522909,401113,121796
2020-11,426145,36992,41361,8797,182624,54847,12969,9463,3533,857,126.0,0,96.84,463137,310061,153076
2020-12,254983,25374,43455,7312,122940,141813,25640,39129,3485,3024,61.24,1,137.52,280357,380289,-99932
2021-01,103785,28563,39554,8634,134151,82006,18800,20491,4090,601,48.85,0,115.46,132348,303636,-171288
2021-02,263391,43955,33365,12912,191613,137135,27503,37626,3453,1461,100.71,0,121.81,307346,440154,-132808
2021-03,446653,30619,23317,11845,92777,213969,10314,8080,1774,709,270.47,1,90.12,477272,360302,116970
2021-04,369328,49600,33711,6248,91724,151571,11496,16905,4766,2040,23.26,1,82.69,418928,311655,107273
2021-05,450512,28697,22687,6984,133367,98875,7065,21154,2426,3945,155.75,0,89.01,479209,290132,189077
2021-06,428948,25771,31392,12289,184446,207986,9713,34443,2856,1307,174.92,0,131.41,454719,480269,-25550
2021-07,487145,42387,23335,10186,81772,144055,18479,7951,1803,1118,234.48,0,112.98,529532,285778,243754
2021-08,493665,29650,34260,12475,87634,240252,7980,25741,2458,888,217.71,1,144.87,523315,408342,114973
2021-09,325554,49834,35639,11800,123982,196389,6930,26208,4053,2048,15.32,1,118.2,375388,400948,-25560
2021-10,184337,16030,41316,10870,113540,75062,29728,31919,2140,2801,168.66,1,133.27,200367,302435,-102068
2021-11,489677,28730,42133,13466,88167,219878,29870,8502,1484,3695,409.6,0,82.54,518407,402016,116391
2021-12,265747,24601,22695,9922,160369,80631,23839,31649,2833,2788,102.44,1,83.64,290348,329105,-38757
2022-01,123078,14506,31622,10756,190862,120425,22772,32902,562,3824,187.95,0,83.91,137584,409339,-271755
2022-02,319118,46483,32853,9831,127041,201337,18730,35707,854,2518,408.61,0,112.44,365601,425499,-59898
2022-03,114577,43839,21954,12947,106129,244658,25970,31831,3535,380,-7.11,1,142.85,158416,443489,-285073
2022-04,261588,28511,43510,7546,155057,138363,22307,13659,2326,1811,106.4,1,141.21,290099,380442,-90343
2022-05,336697,35762,48146,7249,142735,74181,27817,6020,3774,3773,56.65,0,81.45,372459,306148,66311
2022-06,121971,41608,37889,14103,110449,211321,19550,28928,3613,560,27.42,0,99.36,163579,422240,-258661
2022-07,180254,19672,30244,7673,196153,225578,26894,13556,575,417,344.74,0,134.67,199926,500098,-300172
2022-08,347867,30027,24939,13047,174070,146250,29248,19968,4576,3000,47.46,1,90.82,377894,407522,-29628
2022-09,288636,44965,30078,9233,150533,52730,8589,19913,1904,3247,94.88,1,119.97,333601,271076,62525
2022-10,455378,27760,24739,6592,99398,166088,24470,19199,1422,2864,298.15,1,82.61,483138,340486,142652
2022-11,258059,45536,47823,11785,119580,174457,27983,13217,2684,2061,233.46,0,112.45,303595,394845,-91250
2022-12,127583,32453,36986,6387,81979,225126,27409,5243,4715,1842,0.36,1,102.22,160036,383130,-223094
2023-01,339452,27124,25834,10181,150063,116933,25792,37224,1720,583,192.79,0,126.18,366576,366027,549
2023-02,197152,32803,25958,9026,199425,97335,15810,19097,642,2154,273.03,0,102.42,229955,366651,-136696
2023-03,465440,36137,28862,9734,94372,217292,29447,29843,1798,3091,285.05,1,116.62,501577,409550,92027
2023-04,262913,27296,44734,14192,173677,100416,7463,19862,1345,2776,233.08,1,95.59,290209,360344,-70135
2023-05,470318,24127,40677,10672,173197,141133,10083,23645,2927,2648,154.94,0,114.64,494445,399407,95038
2023-06,167763,28553,44436,6894,156880,164111,25682,18866,4039,2221,-17.18,0,114.57,196316,416869,-220553
2023-07,104399,19142,30141,11860,161643,184542,26359,30246,3949,2113,11.44,0,114.56,123541,444791,-321250
2023-08,163320,46222,30561,8971,86196,70022,21893,21879,3824,761,-9.07,1,83.33,209542,239522,-29980
2023-09,324293,18150,33935,14138,141708,248083,16357,6696,3410,3488,143.18,1,146.34,342443,460917,-118474
2023-10,261335,38179,29333,10310,110723,141485,22032,20770,2877,1256,108.87,1,130.37,299514,334653,-35139
2023-11,369715,47029,32762,6506,167721,80107,25149,34923,3509,1481,54.64,0,107.47,416744,347168,69576
2023-12,488464,27521,35212,8041,183633,112328,12481,31672,796,440,628.49,1,93.41,515985,383367,132618
2024-01,295258,29920,48415,7453,159084,230699,23544,10037,4379,1502,33.27,0,81.67,325178,479232,-154054
2024-02,337702,33247,49682,14755,140360,208605,22597,25488,738,1962,485.27,0,117.38,370949,461487,-90538
2024-03,426769,17284,31652,10493,177819,85909,10868,8849,2648,2057,144.12,1,108.27,444053,325590,118463
2024-04,394140,38216,48881,8239,98825,159130,15824,37391,4536,673,27.31,1,129.33,432356,368290,64066
2024-05,296551,32063,21055,12860,153672,57282,25032,6668,4891,568,25.24,0,110.26,328614,276569,52045
2024-06,145727,45681,48477,13332,190897,51317,19791,35565,971,3245,166.32,0,95.76,191408,359379,-167971
2024-07,445533,45373,25330,9219,148533,100062,26859,10802,3221,3972,182.3,0,141.43,490906,320805,170101
2024-08,358881,12388,23329,8128,170578,103207,18207,27180,4401,2351,69.15,1,95.62,371269,350629,20640
2024-09,289587,35730,25934,11086,162019,193185,26754,7081,3556,3068,89.07,1,116.54,325317,426059,-100742
2024-10,444301,10747,48154,9672,175396,244956,19596,16088,3720,3859,58.53,1,80.21,455048,513862,-58814
2024-11,455780,23733,43756,11222,123592,190850,7318,39958,2063,2465,150.88,0,111.09,479513,416696,62817
2024-12,278727,18675,35799,11688,140308,139737,23959,39120,3189,2622,-0.05,1,87.01,297402,390611,-93209
2025-01,290599,44479,37339,10982,135539,123266,20204,11361,2789,3201,93.62,0,106.76,335078,338691,-3613
2025-02,463445,24638,42160,12387,199211,61342,29294,29825,3985,376,126.81,0,142.05,488083,374219,113864
2025-03,401411,23045,33114,14911,83615,87555,9785,17464,2471,3123,149.87,1,105.06,424456,246444,178012
2025-04,365319,36016,42822,7961,176715,234926,6300,13459,4783,2604,110.01,1,120.62,401335,482183,-80848
2025-05,166220,17182,36037,11434,195560,164451,14694,22281,779,683,242.81,0,131.63,183402,444457,-261055
2025-06,478839,15527,32367,6584,145403,84597,17547,34200,4976,3041,141.41,0,118.25,494366,320698,173668
2025-07,291617,28752,35554,14938,142042,156756,19547,37821,3301,2757,156.86,0,96.08,320369,406658,-86289
2025-08,405998,13789,43594,8080,119655,194786,9800,25858,2321,1901,217.14,1,149.05,419787,401773,18014
2025-09,246348,34327,41876,9724,135977,151738,26036,21727,1041,2473,312.78,1,117.6,280675,387078,-106403
2025-10,312363,24672,28505,9837,157217,198406,14541,11433,2089,466,226.83,1,137.97,337035,419939,-82904
2025-11,162429,29493,24533,7668,179699,73020,23243,20006,4462,3806,24.02,0,80.21,191922,328169,-136247
2025-12,488599,17071,46112,6358,163906,136565,22220,16124,3648,393,219.68,1,93.32,505670,391285,114385
2026-01,247808,34575,30494,13169,155915,150964,10347,17147,2576,2915,140.24,0,116.65,282383,378036,-95653
2026-02,211117,33604,48564,7831,93442,55099,20867,28689,3998,2556,-12.01,0,95.06,244721,254492,-9771
2026-03,354018,15922,30553,14530,132773,195636,29859,10132,811,1908,406.31,1,127.42,369940,413483,-43543
2026-04,297354,23877,47628,13489,123612,139163,23525,30216,4424,1397,20.9,1,105.28,321231,377633,-56402
2026-05,363975,37339,31793,12343,89830,232116,25631,34730,3045,1229,207.63,0,82.61,401314,426443,-25129
2026-06,228544,27479,40753,13879,113798,87396,5239,12014,4476,1016,-20.96,0,148.75,256023,273079,-17056
2026-07,352246,29642,49163,6377,175734,56757,23349,34147,4397,1752,113.2,0,81.59,381888,345527,36361
2026-08,483167,48712,25689,6293,100314,131477,12235,10166,1198,1468,376.22,1,126.56,531879,286174,245705
2026-09,208063,20419,38656,10665,138177,134721,14542,27699,2210,300,134.59,1,133.69,228482,364460,-135978
2026-10,290238,44973,28737,6092,80806,71077,28245,13683,1934,3123,126.81,1,125.01,335211,228640,106571
2026-11,477633,28370,26980,9464,118699,167286,26071,9839,3180,1031,195.18,0,127.04,506003,358339,147664
2026-12,151138,27721,49320,12309,109898,211836,24607,24694,942,2195,105.6,1,136.3,178859,432664,-253805
2027-01,423037,14914,46895,13916,174901,222622,29518,10185,600,753,793.98,0,108.44,437951,498037,-60086
2027-02,277361,31743,25408,7264,138719,212481,8742,6276,3066,1534,141.72,0,122.29,309104,398890,-89786
2027-03,232225,49596,31253,11036,83374,128721,19216,8232,4314,2676,122.22,1,98.31,281821,281832,-11
2027-04,260902,19688,30234,14459,123631,233681,13920,14872,4228,3855,115.05,1,122.35,280590,430797,-150207
2027-05,442574,31299,23076,9282,82081,157196,9475,8000,1644,1039,306.64,0,81.03,473873,289110,184763
2027-06,173507,39201,27229,9992,118945,186084,14819,8871,2555,2753,-42.0,0,96.55,212708,365940,-153232
2027-07,207332,33521,33598,5929,157572,216507,27442,17375,3268,1902,85.18,0,94.61,240853,458423,-217570
2027-08,320000,31730,39037,8862,145751,215183,19124,19357,2939,1166,170.78,1,89.33,351730,447314,-95584
2027-09,143708,28429,26324,14677,196781,242178,6454,38193,1403,3927,60.9,1,125.24,172137,524607,-352470
2027-10,255232,37204,34894,8134,157747,228314,12540,19085,2244,1267,120.22,1,135.43,292436,460714,-168278
2027-11,211840,38170,24709,7794,103579,138716,27470,26181,2154,2025,61.03,0,127.3,250010,328449,-78439
2027-12,299283,13102,40765,14746,170852,160647,9576,7959,578,1155,499.56,1,146.9,312385,404545,-92160
2028-01,262687,14253,49919,11551,106603,169013,25056,24834,4767,1764,105.09,0,120.14,276940,386976,-110036
2028-02,225227,25012,26656,5523,81226,165408,14389,22744,3499,3313,6.96,0,95.72,250239,315946,-65707
2028-03,113266,38584,25850,9089,174672,69660,7195,20753,1580,3947,69.18,1,94.84,151850,307219,-155369
2028-04,188395,24900,43912,5698,100302,248404,13825,24035,1766,1778,221.0,1,101.55,213295,436176,-222881
2028-05,376349,27472,24926,14296,103629,173469,8053,37999,1871,3397,252.69,0,138.19,403821,362372,41449
2028-06,420021,19795,34536,8397,166340,170762,21123,23742,1388,3129,334.24,0,123.37,439816,424900,14916
2028-07,317748,31625,29492,9379,121594,104316,18423,20553,1470,3962,242.04,0,101.42,349373,303757,45616
2028-08,181227,14207,23436,14271,145522,227684,6355,12132,2066,1239,51.88,1,86.21,195434,429400,-233966
2028-09,220967,46563,32406,11803,158058,107664,16169,20430,3992,1692,54.41,1,124.1,267530,346530,-79000
2028-10,496132,49237,48709,6885,194143,224444,6683,38838,4394,3897,101.23,1,108.82,545369,519702,25667
2028-11,417965,31724,45342,14835,93604,222866,11885,15236,3527,2990,190.02,0,100.21,449689,403768,45921
2028-12,174630,45713,21105,7637,167496,196544,13618,37152,4772,2662,36.52,1,101.51,220343,443552,-223209
2029-01,344182,46231,26742,9512,181921,81090,27819,30636,1200,994,267.38,0,98.95,390413,357720,32693
2029-02,145073,24165,20769,8107,168100,171768,28781,25278,1645,3216,49.63,0,122.33,169238,422803,-253565
2029-03,402408,15189,44268,10974,188571,55842,13105,7870,1487,3896,230.05,1,142.96,417597,320630,96967
2029-04,196628,32799,43951,9294,80417,188687,11056,34582,1328,1962,209.24,1,118.19,229427,367987,-138560
2029-05,145104,32845,30891,13578,91325,211217,11150,7035,3058,3812,102.51,0,83.3,177949,365196,-187247
2029-06,321846,41046,28478,9317,167864,75134,6410,33573,1598,2616,126.26,0,124.64,362892,320776,42116
2029-07,160180,19099,39200,8129,133838,197912,5397,23434,3447,2930,79.89,0,130.82,179279,407910,-228631
2029-08,152229,47467,34695,6661,82377,92968,26655,28617,766,2602,238.09,1,148.05,199696,271973,-72277
2029-09,453567,35234,37482,7463,112285,141143,22359,7108,4155,3220,86.81,1,116.52,488801,327840,160961
2029-10,461297,38978,25199,10893,169828,108002,16261,16126,3765,3473,169.78,1,87.12,500275,346309,153966
2029-11,102283,12953,30256,6763,114582,152310,6144,11659,3159,1876,64.73,0,141.23,115236,321714,-206478
2029-12,169743,29959,47090,8236,152965,163429,27288,22377,1022,1041,144.17,1,102.31,199702,421385,-221683
2030-01,229987,10039,37823,5674,195100,146106,21410,5596,1761,3205,67.38,0,100.85,240026,411709,-171683
2030-02,180285,11397,31036,9872,186292,174923,13111,37482,994,3276,172.04,0,106.37,191682,452716,-261034
2030-03,333227,14006,44749,5034,133294,171068,14072,31191,2960,2317,150.99,1,96.44,347233,399408,-52175
2030-04,460440,42687,49854,10334,193519,165108,25323,10310,3792,1770,62.57,1,129.71,503127,454448,48679
2030-05,150129,40963,47223,12962,163953,153363,8032,27387,4863,804,66.39,0,117.6,191092,412920,-221828
2030-06,330537,44015,34379,6081,85829,178698,14091,25249,1748,2822,106.61,0,102.95,374552,344327,30225
2030-07,223039,20337,37277,5634,123753,178773,18083,35057,2454,386,108.43,0,89.68,243376,398577,-155201
2030-08,396844,45412,30096,7984,188383,216717,13646,10949,3098,2706,89.74,1,109.71,442256,467775,-25519
2030-09,369065,45028,41409,12969,186915,234670,16924,10949,957,3320,424.08,1,112.6,414093,503836,-89743
2030-10,212203,14658,48014,5907,169442,248252,29740,31552,675,3148,272.81,1,143.31,226861,532907,-306046
2030-11,491148,15202,23071,10847,81623,172018,15918,16755,2721,3386,118.05,0,115.64,506350,320232,186118
2030-12,163011,31284,27660,12931,126285,92130,21898,22693,769,1925,175.8,1,91.78,194295,303597,-109302
2031-01,460541,26640,48954,6201,137303,233903,20337,28112,712,1878,631.47,0,80.7,487181,474810,12371
2031-02,472010,40974,45562,13964,153027,128369,5925,29929,3646,1837,91.13,0,133.54,512984,376776,136208
2031-03,437578,42191,35313,6990,137634,56592,26435,7058,650,1886,752.52,1,90.66,479769,270022,209747
2031-04,391277,26339,22242,13515,188824,181686,14247,37422,2133,1423,151.4,1,141.78,417616,457936,-40320
2031-05,423836,41285,40295,13785,111176,142959,19673,30991,2687,2696,177.57,0,114.32,465121,358879,106242
2031-06,377557,20086,22691,14930,194879,74857,24167,16886,2612,1312,91.05,0,131.85,397643,348410,49233
2031-07,233409,15804,28239,5579,138135,54769,21543,23418,3824,1552,190.79,0,138.0,249213,271683,-22470
2031-08,461721,30864,49327,8487,164386,133747,24868,21008,4532,3304,104.03,1,134.87,492585,401823,90762
2031-09,359537,18810,21801,9911,177336,59825,13967,20377,3492,949,93.46,1,83.98,378347,303217,75130
2031-10,220229,22590,26928,7713,155520,236133,26427,29207,3365,3432,128.41,1,137.23,242819,481928,-239109
2031-11,253875,42149,40014,7522,103962,79078,11343,35126,3863,2920,-67.6,0,106.51,296024,277045,18979
2031-12,390924,43324,34853,10037,94790,91768,25674,35161,1204,1873,260.66,1,87.87,434248,292283,141965
2032-01,473836,38006,32090,5488,196057,214937,21903,9829,1634,2591,296.62,0,94.24,511842,480304,31538
2032-02,355187,30093,32396,13624,92011,221890,28267,39172,726,3107,532.81,0,119.31,385280,427360,-42080
2032-03,459552,34066,39492,13879,103806,116412,6238,17501,973,3092,443.43,1,109.69,493618,297328,196290
2032-04,467468,21016,38279,12310,99779,223556,17866,37462,4523,3453,105.83,1,137.96,488484,429252,59232
2032-05,337831,47442,47456,9937,123549,78819,12952,34013,756,514,465.05,0,120.18,385273,306726,78547
2032-06,335766,14680,46727,13005,122121,174409,26606,7023,1734,2214,219.45,0,121.77,350446,389891,-39445
2032-07,445527,21276,47035,14486,199974,123089,12537,23346,860,3707,492.85,0,110.27,466803,420467,46336
2032-08,115589,49611,32857,8449,145099,116911,19289,39441,4117,2173,-19.45,1,103.77,165200,362046,-196846
2032-09,208245,41486,31430,9094,182521,207102,14713,26923,999,2682,274.71,1,90.8,249731,471783,-222052
2032-10,350438,11882,32163,8377,187111,78081,25639,13242,1815,620,155.82,1,122.4,362320,344613,17707
2032-11,233270,40760,44342,12971,141156,121343,22127,23301,4831,1019,37.12,0,145.42,274030,365240,-91210
2032-12,361736,25595,45079,10550,170677,150646,5552,14454,607,2696,712.34,1,117.91,387331,396958,-9627
2033-01,343867,47826,40944,8562,141725,135954,19814,6829,1578,1481,244.5,0,107.05,391693,353828,37865
2033-02,124950,46859,49489,10728,164695,112763,16099,24252,3533,3242,4.71,0,102.82,171809,378026,-206217
2033-03,141235,38865,27312,8460,123273,76310,21540,8689,772,2817,245.54,1,110.9,180100,265584,-85484
2033-04,287630,42940,30208,9713,152276,233783,12123,30725,4042,2447,98.04,1,146.74,330570,468828,-138258
2033-05,188211,16214,28094,12895,196727,110790,9627,20735,4110,1553,-35.25,0,80.34,204425,378868,-174443
2033-06,303853,11146,49975,8451,178937,155407,11401,31501,2753,728,129.31,0,138.94,314999,435672,-120673
2033-07,498421,27115,47057,10911,140270,51944,11790,27221,4670,3302,178.37,0,135.6,525536,289193,236343
2033-08,285199,27773,41804,14172,94612,115644,20280,37143,2526,3627,73.46,1,80.43,312972,323655,-10683
2033-09,174276,19807,22500,13983,131408,229233,24517,24712,757,1543,264.28,1,80.99,194083,446353,-252270
2033-10,440289,14064,36091,9118,120553,205380,23945,23650,1864,3275,167.99,1,148.63,454353,418737,35616
2033-11,466596,10939,36183,5690,121165,190520,20855,30981,4625,2380,94.79,0,149.16,477535,405394,72141
2033-12,248768,35547,44214,14428,190734,242393,26105,5614,2513,3896,105.69,1,88.85,284315,523488,-239173
2034-01,180073,42961,27212,11622,195261,64443,20020,5847,2824,3721,45.28,0,99.58,223034,324405,-101371
2034-02,194195,23363,43715,5699,178390,214569,11902,38509,1965,1613,37.65,0,114.59,217558,492784,-275226
2034-03,465883,21457,38087,5650,102277,225757,16612,11526,2781,2198,215.9,1,130.99,487340,399909,87431
2034-04,218206,33777,42724,13485,132197,158252,8634,36309,1919,1486,184.15,1,122.0,251983,391601,-139618
2034-05,216026,13299,49794,5222,173890,234798,28498,8834,2921,2166,115.9,0,83.86,229325,501036,-271711
2034-06,428321,47807,20219,7450,163785,182001,9546,38905,3997,1802,32.33,0,99.43,476128,421906,54222
2034-07,140984,11604,22155,10638,143702,163928,26335,34651,3086,2239,12.4,0,108.68,152588,401409,-248821
2034-08,114203,13815,37731,14648,150512,50887,13997,19672,4936,582,66.97,1,115.09,128018,287447,-159429
2034-09,340902,44646,34798,7595,178312,204996,8282,6001,1580,3390,139.42,1,123.93,385548,439984,-54436
2034-10,259021,17267,31631,11987,138086,229897,28554,18724,1506,1948,179.0,1,103.05,276288,458879,-182591
2034-11,486566,13093,36745,8967,102737,181714,5987,7326,688,2932,673.26,0,127.48,499659,343476,156183
2034-12,466272,47024,47418,9673,89112,60320,20302,6750,4268,813,74.89,1,100.03,513296,233575,279721
2035-01,223278,21194,39974,6400,127624,111155,23537,34655,3753,2075,79.88,0,110.19,244472,343345,-98873
2035-02,239947,16601,35952,6960,128314,138585,21204,18124,3574,2068,42.28,0,147.08,256548,349139,-92591
2035-03,476917,31327,49557,12285,168427,241696,19554,14439,2050,3942,225.58,1,82.57,508244,505958,2286
2035-04,339493,13731,28044,10795,184286,249964,17763,6681,2453,520,127.33,1,130.49,353224,497533,-144309
2035-05,296026,13861,30130,8548,141176,125092,27167,29250,2664,2522,52.05,0,129.66,309887,361363,-51476
2035-06,271718,46424,25091,12054,97189,165570,18115,14551,1605,2387,181.93,0,95.21,318142,332570,-14428
2035-07,434362,46777,47908,8346,196163,194415,6558,7900,760,366,607.14,0,114.7,481139,461290,19849
2035-08,206967,34983,38473,6375,127381,169041,21182,15993,2513,3606,109.67,1,143.96,241950,378445,-136495
2035-09,105080,34440,42873,10465,80202,67770,28527,18572,1303,3579,55.1,1,87.64,139520,248409,-108889
2035-10,120025,27371,47313,9107,88483,134268,25248,18148,3473,2411,61.98,1,81.4,147396,322567,-175171
2035-11,158265,23117,20017,13987,89358,117458,29654,11894,3411,3697,69.82,0,95.21,181382,282368,-100986
2035-12,208002,12175,49694,10026,127630,247740,21896,34852,4581,2687,154.61,1,112.43,220177,491838,-271661
2036-01,180606,27069,32108,14156,181407,165496,27771,12338,2969,3992,43.13,0,108.68,207675,433276,-225601
2036-02,136848,42419,25410,7672,152397,218603,18089,7228,2171,2398,-33.98,0,87.25,179267,429399,-250132
2036-03,408503,44478,38861,10081,85122,185632,13386,27098,849,2950,430.24,1,145.11,452981,360180,92801
2036-04,107335,39152,47797,7805,127836,66220,14502,38304,1903,1398,-2.22,1,132.82,146487,302464,-155977
2036-05,282883,16349,26907,5567,181756,139418,27499,35931,2517,1967,145.19,0,126.29,299232,417078,-117846
2036-06,341715,39519,32100,9483,198268,110596,13143,16439,3669,2323,89.72,0,135.57,381234,380029,1205
2036-07,310508,23589,44873,8844,174312,122795,12671,39590,3580,2948,120.45,0,100.18,334097,403085,-68988
2036-08,446235,18105,49516,8140,185824,122390,7048,26541,613,795,628.24,1,142.36,464340,399459,64881
2036-09,415224,26352,46006,6557,138753,61710,7771,39953,543,2218,732.85,1,97.97,441576,300750,140826
2036-10,204196,22363,32755,11811,171813,143902,18302,21288,1881,982,95.33,1,99.45,226559,399871,-173312
2036-11,404859,41994,20919,10379,96388,191021,25372,22043,2932,366,150.77,0,97.88,446853,366122,80731
2036-12,118312,22271,49382,11384,147884,145841,18629,20047,1569,510,134.63,1,109.45,140583,393167,-252584
2037-01,333377,46830,30380,6512,154451,90418,11901,13628,1543,3643,190.53,0,123.41,380207,307290,72917
2037-02,155678,38517,36973,6753,180698,127641,14420,39256,1291,2481,53.8,0,112.11,194195,405741,-211546
2037-03,476075,44940,31144,10861,95960,139173,10870,29774,3917,3714,152.77,1,94.13,521015,317782,203233
2037-04,127165,39826,24907,5246,152698,119105,5522,39509,1822,1654,122.77,1,119.56,166991,346987,-179996
2037-05,102656,42061,35954,11571,181329,178075,16287,24601,4825,2964,82.04,0,84.17,144717,447817,-303100
2037-06,468255,10666,49048,5720,179594,92657,19800,9454,2177,893,222.04,0,146.88,478921,356273,122648
2037-07,272654,45352,37873,10998,171354,202372,14616,14309,4285,350,80.31,0,115.23,318006,451522,-133516
2037-08,257148,49385,46163,10355,160306,68788,29876,30061,2725,1852,12.48,1,123.37,306533,345549,-39016
2037-09,233008,34332,42661,13206,125375,160506,27240,5550,1490,936,160.05,1,112.65,267340,374538,-107198
2037-10,183238,27275,22306,12555,118507,152286,5665,36759,1973,1040,83.63,1,87.52,210513,348078,-137565
2037-11,123539,48674,30867,13193,170325,167107,9455,22796,1505,2219,77.78,0,118.63,172213,413743,-241530
2037-12,225446,26995,27633,10949,94259,181109,19922,31054,3315,2130,102.04,1,136.22,252441,364926,-112485
2038-01,107027,11798,46900,8606,147018,59380,5915,24394,2269,2818,104.83,0,125.13,118825,292213,-173388
2038-02,140122,34887,46784,6578,130101,57541,17630,8693,2250,1822,62.81,0,125.51,175009,267327,-92318
2038-03,222271,20208,31182,8916,91815,52547,29835,14892,2431,3095,171.06,1,99.84,242479,229187,13292
2038-04,212568,46521,31093,6738,154756,215194,24560,13498,571,2679,524.76,1,104.45,259089,445839,-186750
2038-05,444196,11488,33162,9219,179567,214829,14748,22892,691,2579,592.42,0,147.06,455684,474417,-18733
2038-06,390012,32863,39685,13152,149746,130719,23604,29924,4333,2610,10.03,0,87.84,422875,386830,36045
2038-07,318015,27662,40891,5683,167380,132809,5109,12828,589,382,528.99,0,83.09,345677,364700,-19023
2038-08,296240,15575,43249,5918,195376,224628,23065,14463,1537,1460,196.71,1,128.23,311815,506699,-194884
2038-09,456893,11534,22716,8321,177649,247424,5548,28816,4154,3523,251.99,1,119.84,468427,490474,-22047
2038-10,250465,22910,40869,10578,153224,135286,13709,11068,3690,1811,103.58,1,119.48,273375,364734,-91359
2038-11,291821,31161,24456,7036,125322,156960,20276,12890,4889,3010,99.95,0,101.46,322982,346940,-23958
2038-12,407247,11041,42730,13274,188972,225008,26063,19930,4605,2124,72.78,1,85.95,418288,515977,-97689
2039-01,391621,46027,22653,14011,155720,144451,5622,27589,4282,3195,87.05,0,138.33,437648,370046,67602
2039-02,448015,45245,33140,10956,91540,209018,11662,39810,2161,2154,173.2,0,101.48,493260,396126,97134
2039-03,142231,19878,24346,6427,86314,148325,16167,26278,2375,2703,7.38,1,121.67,162109,307857,-145748
2039-04,483342,31586,48571,8426,166208,211634,26759,26762,4513,1053,91.92,1,115.63,514928,488360,26568
2039-05,299558,20983,49638,14805,124265,154233,17200,29732,3228,3452,134.8,0,85.73,320541,389873,-69332
2039-06,364325,44966,37115,7042,124146,114256,9331,21028,3986,1247,68.35,0,135.71,409291,312918,96373
2039-07,128767,18612,29594,8195,140461,80460,18147,17346,3619,2012,28.77,0,87.23,147379,294203,-146824
2039-08,123535,49494,32872,12978,185790,172975,24073,18025,2251,2176,83.04,1,131.06,173029,446713,-273684
2039-09,454757,37187,38391,5101,178140,210231,24734,9005,4626,3804,140.44,1,119.88,491944,465602,26342
2039-10,203108,27437,43589,8923,196432,177151,25813,7376,4187,1374,35.83,1,101.22,230545,459284,-228739
2039-11,251096,32074,37812,5559,167556,87828,25173,11301,806,500,331.76,0,101.81,283170,335229,-52059
2039-12,478863,41241,25323,6520,103693,137565,20928,19479,1348,2621,336.64,1,138.86,520104,313508,206596
2040-01,280218,16454,36372,8695,139631,64157,26211,26002,1945,2187,115.86,0,146.24,296672,301068,-4396
2040-02,479640,46947,34659,8358,126246,244025,23036,35183,1409,1251,308.92,0,141.33,526587,471507,55080
2040-03,195692,47586,24588,14597,199026,217140,6747,12445,2169,3772,72.27,1,126.94,243278,474543,-231265
2040-04,283570,37175,37592,5737,199351,205538,23323,15260,4001,3816,153.0,1,92.2,320745,486801,-166056
2040-05,186257,11352,40620,9130,190789,186603,8312,21632,4868,2003,101.83,0,110.92,197609,457086,-259477
2040-06,209301,11626,27456,11832,182040,140307,24407,16441,4035,1769,42.23,0,103.63,220927,402483,-181556
2040-07,122629,37813,23737,6678,156465,70928,17822,8900,1540,2979,202.45,0,148.85,160442,284530,-124088
2040-08,295182,46613,25391,10984,115411,146689,28469,9393,969,1177,260.96,1,92.47,341795,336337,5458
2040-09,480124,35329,34419,5272,122021,135559,15028,27596,4772,3609,15.62,1,136.04,515453,339895,175558
2040-10,342496,26351,35913,9331,85473,220258,11374,33568,508,2537,562.3,1,121.82,368847,395917,-27070
2040-11,230244,23558,38019,10575,124401,85956,29892,27786,4410,1100,43.59,0,140.81,253802,316629,-62827
2040-12,253601,49358,20371,5518,160069,94225,28083,26629,3511,775,-4.88,1,119.75,302959,334895,-31936
2041-01,323484,41402,23902,9145,139968,220779,26102,5050,4563,351,128.87,0,117.37,364886,424946,-60060
2041-02,214379,26316,26750,13089,146497,169054,23472,33788,1432,915,132.35,0,131.09,240695,412650,-171955
2041-03,216453,15056,47190,10567,109706,85409,17549,17079,3469,745,87.44,1,86.09,231509,287500,-55991
2041-04,484932,27189,34281,12406,97531,138939,20265,13569,1894,1175,225.48,1,110.8,512121,316991,195130
2041-05,269204,41413,47848,5851,198524,159313,23579,20430,1904,1004,150.3,0,108.56,310617,455545,-144928
2041-06,345141,43163,23573,8715,135642,180827,17396,7965,1234,2718,318.13,0,93.37,388304,374118,14186
2041-07,359725,22917,40053,14224,90157,159450,28097,6509,1200,919,277.68,0,83.92,382642,338490,44152
2041-08,199268,33679,38515,12457,186977,62303,16941,19692,1923,522,135.24,1,108.2,232947,336885,-103938
2041-09,376737,20077,21179,11748,98982,200040,22496,24548,607,3023,532.56,1,139.35,396814,378993,17821
2041-10,315574,49096,37460,5781,151358,175486,29478,17670,3462,1407,69.47,1,108.97,364670,417233,-52563
2041-11,191335,18319,37066,7440,172800,191573,7542,36641,4878,2476,57.81,0,138.72,209654,453062,-243408
2041-12,443903,36004,36766,6157,101749,208810,5519,7075,3556,1978,84.92,1,82.88,479907,366076,113831
2042-01,144806,43079,44563,9206,100227,109755,27916,18880,3350,3846,-5.13,0,87.13,187885,310547,-122662
2042-02,334294,29723,41426,5357,170978,248044,12180,7149,2783,3484,100.81,0,143.28,364017,485134,-121117
2042-03,299535,35639,34416,14653,150744,107838,23827,31144,2520,1079,89.14,1,136.98,335174,362622,-27448
2042-04,237840,31635,20980,12178,125571,122541,20670,29201,2099,2209,224.21,1,136.95,269475,331141,-61666
2042-05,407321,32227,24565,13471,167646,237498,16507,36413,4783,602,77.49,0,94.28,439548,496100,-56552
2042-06,404044,11045,25275,7370,195699,185420,21315,25004,4609,871,169.85,0,128.37,415089,460083,-44994
2042-07,178293,26797,21898,7447,183756,88345,29920,28478,3336,533,73.13,0,148.86,205090,359844,-154754
2042-08,151252,47337,33508,5617,149028,189593,7272,5524,2536,1173,-41.03,1,92.61,198589,390542,-191953
2042-09,102226,11438,38351,12925,88996,64920,23535,29587,3438,2788,29.81,1,114.96,113664,258314,-144650
2042-10,129691,49072,22104,14962,127795,222787,24900,39515,3246,3195,18.05,1,112.64,178763,452063,-273300
2042-11,390960,45931,34056,6512,114951,72552,8401,33332,3127,3389,56.64,0,86.31,436891,269804,167087
2042-12,297433,17540,44559,5269,179499,178609,11416,24018,653,1129,500.63,1,140.21,314973,443370,-128397
2043-01,464020,49210,26070,10308,126508,145425,10082,20517,3550,2877,13.02,0,83.08,513230,338910,174320
2043-02,142266,33183,36231,14461,158012,125922,7176,23933,1584,1746,100.08,0,82.95,175449,365735,-190286
2043-03,187302,20762,40004,11397,181059,175814,5615,32932,4531,3981,12.65,1,149.45,208064,446821,-238757
2043-04,483771,43812,42739,5800,143879,200844,16915,26542,4583,1449,65.44,1,140.35,527583,436719,90864
2043-05,230178,46200,22230,6367,137924,215840,15751,36921,892,1937,257.38,0,88.68,276378,435033,-158655
2043-06,407266,34979,35055,8478,106035,160151,17820,14220,4551,1310,152.49,0,80.79,442245,341759,100486
2043-07,394467,21836,40148,10243,154132,209560,8869,26720,2668,2604,57.24,0,136.15,416303,449672,-33369
2043-08,363107,21991,27950,6762,108795,231235,11516,35321,4459,1507,162.94,1,85.32,385098,421579,-36481
2043-09,212883,27444,21467,14659,166191,124927,20133,8958,1680,443,183.53,1,149.88,240327,356335,-116008
2043-10,415800,18687,23753,6861,184034,101575,22938,33766,2992,1374,135.7,1,111.78,434487,372927,61560
2043-11,203352,45469,45184,14493,157842,194320,9658,16241,3275,1851,199.06,0,140.3,248821,437738,-188917
2043-12,113017,16325,46786,9676,164115,58641,28570,37182,1111,396,58.9,1,86.16,129342,344970,-215628
2044-01,340251,48769,41715,13608,178416,145532,14533,14364,572,3802,624.93,0,89.28,389020,408168,-19148
2044-02,485933,14328,21090,6359,83753,216652,20304,9827,2071,822,131.79,0,131.44,500261,357985,142276
2044-03,399881,10176,31456,12431,150073,224711,26226,28815,3806,3090,72.34,1,93.62,410057,473712,-63655
2044-04,443457,30794,44612,7549,103660,82691,19249,15609,609,3584,705.06,1,123.4,474251,273370,200881
2044-05,294339,41423,47969,12730,130926,207994,7354,28633,2383,3931,149.84,0,135.98,335762,435606,-99844
2044-06,257094,17299,40968,12798,170024,79490,19818,18310,4848,984,6.38,0,114.16,274393,341408,-67015
2044-07,199163,25248,33900,7711,112746,86850,5956,35244,3609,2280,86.7,0,117.97,224411,282407,-57996
2044-08,261342,14663,28274,10819,144785,80668,25988,12226,2925,616,92.52,1,96.28,276005,302760,-26755
2044-09,218245,27748,39539,8332,154765,187193,7132,25454,4861,2981,184.2,1,142.36,245993,422415,-176422
2044-10,237996,14364,31808,5967,164337,62414,27629,17353,3885,1764,-4.38,1,134.92,252360,309508,-57148
2044-11,123926,36878,28256,6182,91757,91132,19672,22018,2006,3449,146.71,0,87.72,160804,259017,-98213
2044-12,101303,40110,20541,8657,119986,219615,19702,33343,2419,3714,80.01,1,129.48,141413,421844,-280431
2045-01,418231,42805,46262,5527,183233,245726,25075,16324,1069,3109,415.21,0,115.55,461036,522147,-61111
2045-02,247815,36790,21480,9346,165675,222942,12182,11588,4600,2082,86.39,0,99.08,284605,443213,-158608
2045-03,270324,25792,21376,5279,81331,215977,24892,7487,2452,2945,125.23,1,87.5,296116,356342,-60226
2045-04,318040,20936,27746,12088,131227,154589,17194,13241,1333,1425,107.26,1,122.85,338976,356085,-17109
2045-05,187980,34157,32602,10663,192045,242143,15034,14963,3423,2182,85.74,0,146.85,222137,507450,-285313
2045-06,463051,21024,28529,10328,157699,137584,24078,28239,3513,3546,41.05,0,122.84,484075,386457,97618
2045-07,494877,36364,49794,6478,100943,219600,27457,20998,4246,1960,90.05,0,116.46,531241,425270,105971
2045-08,254512,11480,48349,14104,129904,106855,29474,18185,2579,2240,92.44,1,125.68,265992,346871,-80879
2045-09,433286,48907,42108,7483,174961,164549,25649,20761,1794,1963,284.72,1,148.12,482193,435511,46682
2045-10,201642,36119,37497,11247,117819,218695,25122,27311,870,3969,160.82,1,100.79,237761,437691,-199930
2045-11,285920,13612,31868,10191,81344,146618,7830,11728,4678,2518,104.08,0,94.69,299532,289579,9953
2045-12,254971,31231,25732,9701,118188,58874,6617,9377,671,1554,421.65,1,109.87,286202,228489,57713
2046-01,471540,28612,21876,9319,190920,57199,12540,13690,1422,2282,387.19,0,87.37,500152,305544,194608
2046-02,300641,44284,35347,10760,150775,128527,18459,5292,1591,3769,170.67,0,99.74,344925,349160,-4235
2046-03,333929,31526,46969,11164,85521,99569,6224,22960,917,1841,383.06,1,83.37,365455,272407,93048
2046-04,231145,34195,43740,8511,98002,160365,18695,7940,2126,3171,82.7,1,110.37,265340,337253,-71913
2046-05,326052,28121,22016,6160,126462,162234,10870,8040,4326,2355,119.95,0,147.65,354173,335782,18391
2046-06,250510,12239,49771,8344,117978,91338,29807,10321,2963,491,23.3,0,134.0,262749,307559,-44810
2046-07,120806,36264,33639,8259,162058,137750,25862,24790,3806,1429,56.05,0,99.54,157070,392358,-235288
2046-08,303328,26039,23766,6399,157335,206241,5632,32435,1627,3465,239.02,1,84.85,329367,431808,-102441
2046-09,175854,22652,45646,9764,118760,57543,8419,17245,840,2811,140.83,1,123.68,198506,257377,-58871
2046-10,148292,25527,38217,7398,169671,205148,20634,23373,4182,1975,-48.38,1,139.62,173819,464441,-290622
2046-11,375087,43818,32853,12312,182465,216333,25142,27675,3865,1085,96.07,0,116.97,418905,496780,-77875
2046-12,457254,10254,21220,14763,162801,63690,25848,17118,4611,3826,95.06,1,109.01,467508,305440,162068
2047-01,325197,32264,46025,8286,135134,220040,14932,7763,4011,2974,41.52,0,99.3,357461,432180,-74719
2047-02,226319,33756,30072,5787,144807,66798,12377,31086,2709,1627,64.07,0,81.75,260075,290927,-30852
2047-03,134752,35452,42906,13277,144867,205605,28006,14895,1888,1681,-59.11,1,136.38,170204,449556,-279352
2047-04,337011,31237,45445,9477,120405,170555,7883,30844,1588,2281,203.05,1,86.91,368248,384609,-16361
2047-05,474700,16544,41331,14599,159133,193757,18270,21462,4531,3437,95.59,0,94.17,491244,448552,42692
2047-06,277439,29408,22711,11997,120029,156064,5602,33098,2417,2981,111.63,0,136.31,306847,349501,-42654
2047-07,311316,43947,37118,12421,140053,215033,16537,29896,2070,3579,116.34,0,135.6,355263,451058,-95795
2047-08,325106,27084,31874,5103,98626,181206,24133,15640,1185,1797,239.0,1,122.26,352190,356582,-4392
2047-09,365701,23058,45257,8994,100162,228233,12560,30704,3194,1112,148.31,1,146.35,388759,425910,-37151
2047-10,105291,10774,42979,10033,132583,196955,25113,32523,4300,3326,-82.63,1,87.66,116065,440186,-324121
2047-11,429422,33105,24780,8654,155604,230110,9474,28177,1723,3362,191.44,0,115.64,462527,456799,5728
2047-12,285258,18830,31551,14492,140823,57794,15466,5488,4814,668,88.03,1,90.5,304088,265614,38474
2048-01,270950,32690,48964,10208,119582,121489,11405,38492,1661,2238,132.65,0,131.16,303640,350140,-46500
2048-02,272426,13537,21228,8264,137907,104960,8622,16881,2975,2133,203.9,0,146.49,285963,297862,-11899
2048-03,191224,29429,36154,8600,133514,203235,17997,25828,1474,2647,51.92,1,92.32,220653,425328,-204675
2048-04,391025,25030,44959,9102,157303,115858,13017,7982,971,3700,384.3,1,129.98,416055,348221,67834
2048-05,442374,11839,21440,9698,117408,224667,16206,37357,2525,3050,187.09,0,100.06,454213,426776,27437
2048-06,498706,36243,42193,13609,186566,51942,9780,13412,3882,3237,235.72,0,131.25,534949,317502,217447
2048-07,436625,20958,42951,10815,93137,132087,12240,9008,4791,3769,100.2,0,102.34,457583,300238,157345
2048-08,476235,28930,37270,14301,199782,212170,24403,32187,1548,3470,220.8,1,92.4,505165,520113,-14948
2048-09,357403,38744,41672,11529,199776,162045,19001,31402,2624,844,151.35,1,101.45,396147,465425,-69278
2048-10,255314,32496,32126,11241,188864,244173,15941,8880,3776,747,109.14,1,83.0,287810,501225,-213415
2048-11,263671,21723,32509,9631,150896,106701,15978,26568,1895,2225,153.54,0,104.69,285394,342283,-56889
2048-12,493110,12084,25319,9987,96399,89311,10490,17104,2604,3842,202.35,1,101.51,505194,248610,256584
2049-01,448807,27043,44496,5469,149805,218396,24816,34126,1180,3584,360.92,0,140.63,475850,477108,-1258
2049-02,284816,16444,35175,11219,98037,233336,12050,27464,515,1149,581.11,0,87.23,301260,417281,-116021
2049-03,494822,42760,35541,8147,188550,166982,9379,29869,1765,3809,333.92,1,119.94,537582,438468,99114
2049-04,431037,19359,45010,12799,84829,246429,18123,23808,1870,904,210.41,1,140.36,450396,430998,19398
2049-05,186218,35283,20146,14178,134567,187194,6117,24254,1139,1921,223.28,0,107.44,221501,386456,-164955
2049-06,313615,21558,37113,8999,82287,210976,26726,15579,3306,2835,126.22,0,147.87,335173,381680,-46507
2049-07,183680,11903,48235,12034,129621,93833,5403,34190,1440,3506,109.04,0,132.37,195583,323316,-127733
2049-08,331439,34802,37635,5937,164651,236184,5987,23888,2762,884,123.01,1,132.27,366241,474282,-108041
2049-09,434330,38683,47217,9160,143252,129420,19771,23815,4457,1652,63.88,1,99.47,473013,372635,100378
2049-10,301450,41784,42644,5365,172208,204887,7914,5408,3040,414,137.3,1,141.12,343234,438426,-95192
2049-11,479548,21410,21179,13921,137841,63694,29845,34323,3880,3656,240.04,0,108.91,500958,300803,200155
2049-12,263181,10607,49137,12173,176073,158249,11207,15606,4006,3969,71.08,1,87.86,273788,422445,-148657
2050-01,346958,26690,48591,9653,127014,93728,7609,37177,1923,318,193.39,0,110.28,373648,323772,49876
2050-02,296799,29626,39055,14630,124457,149357,13442,12317,3062,3377,111.64,0,96.62,326425,353258,-26833
2050-03,298224,37477,49557,8768,170567,182151,12054,7887,768,2142,412.84,1,133.18,335701,430984,-95283
2050-04,158203,25559,21828,13519,123087,212836,24773,38438,3234,3244,52.09,1,142.79,183762,434481,-250719
2050-05,219086,49751,22410,7426,90052,168453,23893,30630,862,933,287.23,0,97.28,268837,342864,-74027
2050-06,489304,23797,48336,7653,188126,111638,18518,33356,4161,2444,129.19,0,141.94,513101,407627,105474
2050-07,484989,25602,36774,12684,176531,155066,27205,8237,2625,2781,107.14,0,134.19,510591,416497,94094
2050-08,250478,15969,24719,5148,137309,173640,20122,26041,2925,3981,136.48,1,133.72,266447,386979,-120532
2050-09,142763,26315,49542,11193,184376,58461,8991,32521,3042,2114,115.44,1,126.13,169078,345084,-176006
2050-10,438206,11631,37647,7092,198674,222085,11876,38793,4620,3763,71.74,1,117.69,449837,516167,-66330
2050-11,179981,32994,31036,5980,195154,198742,12038,13360,1328,799,167.05,0,132.47,212975,456310,-243335
2050-12,210498,40413,47589,6957,142286,94731,12129,7362,3693,2441,70.66,1,85.93,250911,311054,-60143
2051-01,341385,23712,27183,6679,120114,76850,14291,30776,2939,3984,108.72,0,113.98,365097,275893,89204
2051-02,360029,21231,29491,10890,86848,207589,18712,36957,3291,3214,192.18,0,126.77,381260,390487,-9227
2051-03,395911,12147,20850,14738,179854,139002,22054,28897,4887,480,97.5,1,135.67,408058,405395,2663
2051-04,438075,49651,29189,11096,129434,124893,13047,12317,2947,1442,119.73,1,104.89,487726,319976,167750
2051-05,239963,20452,40385,9037,138738,191957,7283,8510,1538,1531,122.08,0,80.97,260415,395910,-135495
2051-06,450923,13917,45656,9831,135710,109703,17293,15082,4282,3683,93.18,0,118.72,464840,333275,131565
2051-07,489962,46335,42937,11288,159415,177740,23620,31526,4836,382,152.79,0,147.82,536297,446526,89771
2051-08,411520,21092,46466,5064,149633,103365,8060,9773,3472,2218,82.09,1,137.5,432612,322361,110251
2051-09,449305,32698,33378,7650,118782,91186,12978,38944,4800,2027,145.51,1,89.94,482003,302918,179085
2051-10,459916,46566,39474,8236,199702,59098,25843,30973,2339,3809,144.15,1,125.67,506482,363326,143156
2051-11,407396,12890,33776,13682,127289,67668,27366,23109,2384,800,181.62,0,89.22,420286,292890,127396
2051-12,331815,10680,38957,6912,163410,147869,22790,17606,4908,1914,71.57,1,101.87,342495,397544,-55049
2052-01,245466,27318,30638,12981,147725,120356,9226,28123,825,3659,297.93,0,139.17,272784,349049,-76265
2052-02,426789,30732,29088,8568,119098,171763,16773,29190,1466,797,348.28,0,117.21,457521,374480,83041
2052-03,459403,45773,46471,10968,85925,140447,27309,25654,3469,1965,138.49,1,101.95,505176,336774,168402
2052-04,156187,22310,45844,13805,190801,243068,8335,26878,4290,1462,-5.57,1,89.02,178497,528731,-350234
2052-05,183187,33970,32287,11416,165499,149858,28708,30962,1387,1971,124.13,0,103.15,217157,418730,-201573
2052-06,136108,34439,40241,8272,181439,92664,5921,31195,4990,3139,20.34,0,118.02,170547,359732,-189185
2052-07,263523,15071,23681,11813,97913,212585,28606,10071,3821,1188,85.22,0,133.82,278594,384669,-106075
2052-08,268979,10254,35479,6642,99023,139487,29475,9017,4809,324,68.31,1,111.2,279233,319123,-39890
2052-09,348127,42669,44347,10196,189126,125968,11556,31313,3391,3341,-5.19,1,117.85,390796,412506,-21710
2052-10,454426,31014,36528,5963,146343,211528,29901,23287,2778,1780,235.65,1,84.0,485440,453550,31890
2052-11,310656,35825,38195,9112,108006,218768,28091,22766,4529,361,71.69,0,148.96,346481,424938,-78457
2052-12,382642,36083,31776,13502,112314,145078,9842,36876,3853,3738,89.84,1,89.67,418725,349388,69337
2053-01,142050,43840,46402,14372,177294,82021,29265,14745,3211,390,100.45,0,111.93,185890,364099,-178209
2053-02,422789,13362,21848,6413,179913,58862,24795,6384,808,3035,604.39,0,89.46,436151,298215,137936
2053-03,491099,34993,41277,6603,191658,159722,11629,38997,1291,3975,346.69,1,132.98,526092,449886,76206
2053-04,219969,38447,34535,12278,163667,104035,8432,13709,907,609,222.18,1,86.14,258416,336656,-78240
2053-05,356234,36377,41849,6354,91081,196337,11232,32061,3812,2594,218.74,0,101.48,392611,378914,13697
2053-06,413941,20046,38054,12465,139042,76104,25744,18835,3297,3959,76.71,0,124.41,433987,310244,123743
2053-07,384885,22996,47990,6870,167772,239340,29114,24364,4481,3478,83.77,0,100.37,407881,515450,-107569
2053-08,234806,43758,35627,13760,189855,224994,8519,32904,2076,2200,111.54,1,97.01,278564,505659,-227095
2053-09,289737,37256,38142,11341,188453,245919,6334,27344,4480,720,106.72,1,132.72,326993,517533,-190540
2053-10,301061,16302,31883,8268,144205,239685,25108,32924,1786,3034,182.98,1,80.34,317363,482073,-164710
2053-11,441017,12075,47939,5753,120944,213267,19721,32163,2058,3906,221.14,0,82.32,453092,439787,13305
2053-12,361941,31790,30756,13960,152598,84067,11876,18616,1923,3334,185.72,1,81.14,393731,311873,81858
2054-01,182073,14297,43122,6932,174458,117332,9648,14683,4610,757,-41.84,0,147.12,196370,366175,-169805
2054-02,175714,45893,28435,10831,83993,181412,7360,18186,3351,1680,39.64,0,118.98,221607,330217,-108610
2054-03,390349,41591,34879,5571,151158,247154,25096,29535,3845,884,49.42,1,143.08,431940,493393,-61453
2054-04,225848,35173,40773,8495,171121,216767,23927,20886,1748,1295,131.29,1,107.66,261021,481969,-220948
2054-05,211106,16077,30979,5944,101743,144135,12719,12800,4740,3486,38.17,0,87.75,227183,308320,-81137
2054-06,181449,17820,33604,12499,110512,82064,8720,34649,1851,2974,211.66,0,106.94,199269,282048,-82779
2054-07,283370,39376,43249,10778,107008,176354,26684,7512,1222,3173,146.68,0,142.45,322746,371585,-48839
2054-08,173446,15378,45795,5605,88193,184410,8950,29947,1629,2793,154.2,1,96.62,188824,362900,-174076
2054-09,378701,21595,41861,8681,188730,211865,11512,13928,1956,3362,227.98,1,126.71,400296,476577,-76281
2054-10,484124,27663,23836,5792,130173,191448,7105,15990,570,3836,833.11,1,87.76,511787,374344,137443
2054-11,129914,37955,32961,6880,194643,130981,14725,36569,974,3765,144.87,0,89.72,167869,416759,-248890
2054-12,186317,34932,22239,7387,131061,166410,8225,39574,3385,1573,84.49,1,99.54,221249,374896,-153647
2055-01,172529,47632,43068,13075,110551,229863,9227,6551,2291,1683,224.27,0,126.42,220161,412335,-192174
2055-02,147095,38431,38461,11565,137800,139311,6148,12194,640,2357,158.85,0,130.55,185526,345479,-159953
2055-03,326090,30111,29295,9542,105737,117506,22827,19346,2017,3104,114.98,1,133.76,356201,304253,51948
2055-04,411470,13673,26989,12403,134180,193600,7103,6927,3032,741,202.61,1,119.57,425143,381202,43941
2055-05,277468,33102,48237,6734,177167,175764,12595,32208,4495,523,67.22,0,99.4,310570,452705,-142135
2055-06,301179,46520,42777,14834,154174,169115,26321,25987,584,2367,589.86,0,123.9,347699,433208,-85509
2055-07,112763,43576,37828,13802,128583,63342,10011,25547,3477,1649,-37.91,0,97.45,156339,279113,-122774
2055-08,461230,21575,34195,14396,103631,233805,18207,22990,4211,3337,117.38,1,84.61,482805,427224,55581
2055-09,322381,47657,33583,10836,141920,67921,13361,8651,1761,2402,205.15,1,108.33,370038,276272,93766
2055-10,218512,37861,45462,14889,165481,178975,28256,10225,4834,2351,52.79,1,127.51,256373,443288,-186915
2055-11,369995,49678,48931,5806,150290,182678,29669,39813,2360,2967,152.22,0,104.89,419673,457187,-37514
2055-12,281408,19528,26201,5932,148092,73449,19331,18201,2554,712,173.18,1,121.3,300936,291206,9730
2056-01,351758,42735,40318,7029,163289,156990,22145,21789,3594,1399,146.89,0,121.27,394493,411560,-17067
2056-02,361819,34979,38204,9496,174202,55081,13011,25224,3365,1612,278.59,0,97.07,396798,315218,81580
2056-03,204959,32107,25198,8189,195510,197739,23175,16965,887,3907,293.7,1,125.77,237066,466776,-229710
2056-04,184012,25277,43376,10359,125490,192943,27137,11799,3886,3643,101.94,1,145.81,209289,411104,-201815
2056-05,308647,23461,45092,12737,137990,94716,29535,20235,1192,1281,285.13,0,111.08,332108,340305,-8197
2056-06,149715,24299,23627,7732,173911,61532,18445,31154,3573,2655,90.02,0,143.72,174014,316401,-142387
2056-07,184411,34016,48957,6932,134376,248722,26813,32447,1730,1849,58.55,0,84.15,218427,498247,-279820
2056-08,224517,14408,21785,5351,170136,241737,7143,6925,3607,942,103.45,1,143.72,238925,453077,-214152
2056-09,175746,16723,45961,6419,190136,221560,21376,29193,4965,1073,77.54,1,121.67,192469,514645,-322176
2056-10,288821,17100,24593,11988,136110,106225,19075,23325,4346,3047,76.55,1,148.73,305921,321316,-15395
2056-11,162560,23125,26630,13034,174598,85266,21654,15802,2184,903,79.01,0,103.61,185685,336984,-151299
2056-12,470562,47894,45447,10704,160723,139563,25857,32239,2002,511,167.3,1,103.25,518456,414533,103923
2057-01,370580,39248,41144,12352,172133,99720,21432,11197,959,1117,388.32,0,102.52,409828,357978,51850
2057-02,377664,16234,42842,14897,88422,174510,13536,10068,4829,3303,126.85,0,98.98,393898,344275,49623
2057-03,350104,39264,47122,7602,117342,103116,25987,28187,1075,897,275.48,1,89.75,389368,329356,60012
2057-04,463125,22896,43869,10470,158345,201647,20546,31297,2752,1576,248.48,1,87.22,486021,466174,19847
2057-05,255106,16226,44203,5702,121465,203950,26822,16676,2780,2021,43.67,0,142.17,271332,418818,-147486
2057-06,422467,26145,30261,9703,89128,231889,27822,36136,4463,1727,45.02,0,105.26,448612,424939,23673
2057-07,140835,14986,29758,11428,126962,220400,7624,27047,919,352,189.67,0,93.99,155821,423219,-267398
2057-08,100189,17651,34822,8199,183830,194199,19837,12515,1119,3936,43.02,1,125.35,117840,453402,-335562
2057-09,401774,15972,34315,11164,162857,241293,24754,22169,4246,1704,34.59,1,96.03,417746,496552,-78806
2057-10,287069,32801,40412,12221,87726,185055,6337,13968,2086,1265,76.18,1,100.85,319870,345719,-25849
2057-11,441561,38917,34881,5447,183352,155721,25469,29377,1288,904,410.46,0,115.78,480478,434247,46231
2057-12,312926,15317,44986,5673,104468,163553,26684,19881,3049,2695,138.48,1,130.7,328243,365245,-37002
2058-01,423694,47508,39659,5359,172809,88365,24473,30963,4975,2963,18.44,0,116.31,471202,361628,109574
2058-02,456786,36257,26606,13833,156273,135805,17544,28287,2024,3271,237.99,0,120.59,493043,378348,114695
2058-03,384716,21208,40388,5502,183519,96536,29053,18745,3352,1304,70.09,1,146.6,405924,373743,32181
2058-04,462459,20488,34856,9772,175951,222826,12001,11064,1173,1140,361.97,1,114.33,482947,466470,16477
2058-05,232501,28876,47811,9075,193545,182859,14478,27621,4188,3213,76.91,0,121.27,261377,475389,-214012
2058-06,117394,21301,45571,13915,112630,196795,18698,28143,4474,948,116.88,0,97.97,138695,415752,-277057
2058-07,184004,37916,39634,9858,99742,228721,9165,39628,1257,2767,186.04,0,131.23,221920,426748,-204828
2058-08,127919,26662,28361,10188,184906,207454,13260,6699,4940,3627,-20.64,1,149.25,154581,450868,-296287
2058-09,295598,36942,38183,13147,120248,208499,14391,18791,1576,2790,153.13,1,124.6,332540,413259,-80719
2058-10,364205,30344,25981,5454,169566,201011,12066,9552,1236,472,210.31,1,121.28,394549,423630,-29081
2058-11,277362,44999,23807,9486,89850,104188,23627,5446,4961,2784,56.27,0,139.48,322361,256404,65957
2058-12,480612,47651,30182,6461,101568,117734,17495,25672,2629,2983,152.15,1,130.47,528263,299112,229151
2059-01,466248,31279,32916,12148,126314,187133,18353,30290,2238,2755,221.14,0,91.29,497527,407154,90373
2059-02,439635,41387,37750,13050,178079,50505,22223,30370,1570,2266,234.45,0,85.45,481022,331977,149045
2059-03,387711,32971,26450,14246,139702,168494,13845,15750,3414,3482,34.98,1,117.1,420682,378487,42195
2059-04,155216,36975,22047,8776,101298,164057,7238,20722,1908,397,67.74,1,144.33,192191,324138,-131947
2059-05,342854,43762,26470,9635,199018,132519,22621,12457,4982,3739,160.86,0,89.68,386616,402720,-16104
2059-06,183260,36095,49382,6870,113769,93416,7114,14830,3504,3993,23.11,0,107.06,219355,285381,-66026
2059-07,484802,31592,23453,6252,169749,116112,24275,34386,2458,2074,144.09,0,117.11,516394,374227,142167
2059-08,111225,23653,23824,10868,153006,178835,25945,26036,4256,3023,73.27,1,113.69,134878,418514,-283636
2059-09,305246,36006,45263,14534,109703,101287,14413,34345,3260,2666,-23.8,1,125.26,341252,319545,21707
2059-10,146305,37742,31370,9103,193349,134081,9309,28063,4939,1920,2.58,1,84.5,184047,405275,-221228
2059-11,316267,45825,28998,13842,165582,79040,10726,35486,1442,3755,178.13,0,116.85,362092,333674,28418
2059-12,381673,26022,32022,11613,170796,209947,22570,22724,590,2562,606.12,1,126.25,407695,469672,-61977
2060-01,248067,30543,27018,12909,88993,213411,19327,34448,4415,3507,89.85,0,107.01,278610,396106,-117496
2060-02,473711,15162,36546,8149,129715,67875,8840,11290,1931,3857,244.52,0,110.97,488873,262415,226458
2060-03,474497,25147,23615,9046,81334,238569,11679,24468,3444,2488,184.64,1,85.31,499644,388711,110933
2060-04,366787,24816,31458,12689,127081,224597,10525,33670,3680,3202,129.12,1,110.17,391603,440020,-48417
2060-05,223985,38207,21766,8287,117940,138075,13656,6098,2409,2774,94.64,0,80.21,262192,305822,-43630
2060-06,437450,35460,37305,8922,142498,227470,27984,15804,1895,3555,205.93,0,115.8,472910,459983,12927
2060-07,253745,10900,28097,7068,102626,70104,26150,21868,4076,3538,100.86,0,146.29,264645,255913,8732
2060-08,318209,41477,39056,7272,158130,116024,19631,18281,2911,2403,136.6,1,147.13,359686,358394,1292
2060-09,242481,40877,33858,10590,189372,59482,13532,39837,4377,3972,38.1,1,131.14,283358,346671,-63313
2060-10,152163,39133,31573,11241,154746,52053,19684,18482,884,1158,169.14,1,117.6,191296,287779,-96483
2060-11,247519,22252,24223,14564,148243,76353,6075,22368,946,3423,291.09,0,138.0,269771,291826,-22055
2060-12,375906,10360,27825,14405,143434,230822,12193,31616,2152,1796,123.55,1,109.68,386266,460295,-74029
2061-01,426850,49355,25496,9531,174021,55217,26776,33716,3706,3217,72.76,0,91.9,476205,324757,151448
2061-02,328684,46764,43701,14362,99336,133526,28376,33902,3832,1803,21.99,0,148.63,375448,353203,22245
2061-03,145859,38873,41216,12877,113535,162387,23697,8375,2417,3208,65.23,1,129.15,184732,362087,-177355
2061-04,257169,33901,21902,5222,120822,140073,7165,13687,2002,2606,170.53,1,135.58,291070,308871,-17801
2061-05,324465,19540,47864,5004,105550,171375,25657,36419,2465,472,187.27,0,130.59,344005,391869,-47864
2061-06,108597,17663,36179,9316,99873,54684,14717,19871,2373,1153,88.78,0,144.96,126260,234640,-108380
2061-07,361172,25426,44124,13934,117723,199489,21551,29712,1355,2499,265.89,0,113.02,386598,426533,-39935
2061-08,464170,38457,32011,12738,183430,180208,9734,13893,1845,3167,220.3,1,130.02,502627,432014,70613
2061-09,342784,31706,46810,8622,151475,90930,11940,31190,4198,1624,95.31,1,149.17,374490,340967,33523
2061-10,477554,20409,46360,11048,156616,154791,24091,23519,3256,2924,175.85,1,108.8,497963,416425,81538
2061-11,491509,24161,21914,8889,175398,226069,21921,7088,1904,1874,251.67,0,93.76,515670,461279,54391
2061-12,401048,46259,22273,11672,142423,58525,24241,15296,4293,2932,76.11,1,133.24,447307,274430,172877
2062-01,208128,15154,47569,13314,110232,68139,24007,30098,4444,1826,-44.9,0,143.81,223282,293359,-70077
2062-02,125443,43522,36585,14826,80492,70997,5640,33439,2455,363,95.9,0,126.33,168965,241979,-73014
2062-03,376581,43718,33282,5718,113144,58006,15626,27056,1154,3479,354.2,1,138.6,420299,252832,167467
2062-04,168631,29015,26514,9762,94647,94843,26360,35852,4783,1439,99.46,1,148.63,197646,287978,-90332
2062-05,362354,21924,36858,7797,118632,229711,5836,36664,1966,1885,232.04,0,118.93,384278,435498,-51220
2062-06,321923,49661,28502,12673,180168,241609,14690,27839,3560,789,140.38,0,109.59,371584,505481,-133897
2062-07,195927,25189,42637,6587,194118,66801,14255,20352,3013,3747,45.74,0,102.4,221116,344750,-123634
2062-08,364538,20594,23473,11544,125959,166010,14977,13484,3759,1440,111.3,1,120.33,385132,355447,29685
2062-09,406508,30406,23965,8828,174477,126348,10440,27994,2696,2427,114.78,1,139.54,436914,372052,64862
2062-10,359429,26669,38332,11737,85257,58928,15298,7014,2747,1045,110.19,1,83.59,386098,216566,169532
2062-11,117408,32934,40240,8581,109162,98694,14884,23044,4995,2338,-28.24,0,116.53,150342,294605,-144263
2062-12,499015,24322,21215,14173,180925,146683,7779,21720,2719,399,204.42,1,117.17,523337,392495,130842
2063-01,194726,34783,37754,5184,144491,67806,13010,27964,942,3065,187.66,0,139.67,229509,296209,-66700
2063-02,372895,20891,35241,9015,121333,94148,21484,34335,508,1612,778.52,0,86.58,393786,315556,78230
2063-03,166429,43658,38197,7499,97833,157698,21959,26012,2173,3846,64.54,1,119.12,210087,349198,-139111
2063-04,258059,32717,28283,14881,95738,248977,6509,9285,2622,3311,149.52,1,144.72,290776,403673,-112897
2063-05,352765,24301,31275,12858,113302,62279,29706,33235,672,2306,575.43,0,136.9,377066,282655,94411
2063-06,492640,25204,49559,11312,84341,106188,18488,31731,2770,2746,156.53,0,84.2,517844,301619,216225
2063-07,365069,31104,21134,9212,115471,167837,19384,12230,1988,368,152.0,0,115.18,396173,345268,50905
2063-08,304172,19078,29187,5365,86334,146951,7476,27392,2939,3486,168.77,1,116.9,323250,302705,20545
2063-09,455605,35595,40279,7279,188786,72458,25623,21524,4581,3801,82.13,1,128.02,491200,355949,135251
2063-10,436823,18846,31729,5609,113376,98374,8785,9866,2497,3863,97.22,1,94.03,455669,267739,187930
2063-11,111429,14478,39816,11704,160399,119208,15800,22118,1866,2280,123.18,0,126.33,125907,369045,-243138
2063-12,353295,35208,22286,7921,140386,200351,15313,26904,2903,2934,183.2,1,123.66,388503,413161,-24658
2064-01,488963,45482,20546,10684,146657,86162,15992,28355,1241,3841,447.11,0,138.72,534445,308396,226049
2064-02,497601,11589,21729,10316,82010,170135,7271,28278,4642,1116,185.96,0,93.01,509190,319739,189451
2064-03,265864,32145,44726,13792,182073,90459,25773,34270,1225,1647,229.32,1,129.16,298009,391093,-93084
2064-04,459857,11217,42254,8749,181067,52757,10854,18316,2055,2121,211.48,1,109.99,471074,313997,157077
2064-05,186520,46460,21149,7456,178002,217671,22561,10745,1064,2616,239.39,0,120.66,232980,457584,-224604
2064-06,222281,23326,20376,14596,146207,232061,12474,36251,3400,2491,60.75,0,102.85,245607,461965,-216358
2064-07,416403,49842,41146,7506,153214,139316,23379,27068,2081,3072,213.26,0,144.07,466245,391629,74616
2064-08,468338,44629,38351,9912,133734,136473,7322,37693,3481,2414,65.65,1,125.25,512967,363485,149482
2064-09,397640,44739,46165,13028,198730,201165,27591,31344,3797,3623,71.39,1,90.14,442379,518023,-75644
2064-10,355502,33405,40929,11767,157742,189525,10097,15921,3473,3869,79.0,1,122.81,388907,425981,-37074
2064-11,114402,11505,28021,12537,111946,101954,24133,25956,2584,1162,116.59,0,81.74,125907,304547,-178640
2064-12,416137,20619,35646,10247,179828,140788,15485,32046,4592,2739,198.02,1,120.62,436756,414040,22716
2065-01,466600,32996,22915,7617,149288,167496,17520,20648,1363,717,342.0,0,140.75,499596,385484,114112
2065-02,391444,19103,28645,13171,175582,159167,26038,6861,1389,813,300.56,0,105.63,410547,409464,1083
2065-03,447376,43079,41598,10314,146285,82832,26768,8450,4498,905,122.32,1,124.88,490455,316247,174208
2065-04,344363,40406,36602,14423,170350,125161,11430,20745,753,1849,559.85,1,93.05,384769,378711,6058
2065-05,291930,42432,31717,10489,109705,217108,17575,19277,1242,2885,255.02,0,119.11,334362,405871,-71509
2065-06,249024,14037,27739,14670,92773,182683,6801,16743,2887,2440,18.09,0,127.48,263061,341409,-78348
2065-07,198170,25440,26714,13841,161567,207787,21737,33642,1101,1895,117.26,0,132.64,223610,465288,-241678
2065-08,220773,11900,48469,7268,111936,218633,20461,37516,4875,2234,61.39,1,92.25,232673,444283,-211610
2065-09,125071,36973,34223,14717,98880,104663,19995,35342,4708,1548,147.98,1,119.8,162044,307820,-145776
2065-10,145172,26276,43198,14416,148237,248663,24391,9067,3810,3414,75.21,1,128.02,171448,487972,-316524
2065-11,445966,27868,39001,14694,195662,169238,12079,13634,2149,2676,319.71,0,85.77,473834,444308,29526
2065-12,450557,40502,47271,5514,92623,192211,11359,34342,2371,2058,140.06,1,93.04,491059,383320,107739
2066-01,473074,46253,40280,11581,188724,60975,13011,39668,2208,3697,198.52,0,80.05,519327,354239,165088
2066-02,162260,42991,30664,12442,140092,110865,17579,38794,964,2526,154.64,0,85.54,205251,350436,-145185
2066-03,104762,45506,22828,14809,194496,58949,12277,8522,1346,1236,80.07,1,118.21,150268,311881,-161613
2066-04,440652,45689,36438,5895,176453,108771,13027,6638,1986,3443,139.4,1,126.41,486341,347222,139119
2066-05,436885,26051,25818,13395,87865,173585,7097,36028,1768,3476,286.97,0,127.6,462936,343788,119148
2066-06,416056,37014,26212,7722,150548,69296,5530,10247,4826,3554,83.7,0,134.08,453070,269555,183515
2066-07,445337,47154,26765,10133,105291,143422,24413,11814,3712,1417,26.42,0,149.89,492491,321838,170653
2066-08,299515,19784,46245,6601,128369,96394,12310,13183,3496,1996,126.46,1,80.67,319299,303102,16197
2066-09,398669,20288,31035,6793,93285,151747,24134,16033,2501,1048,155.53,1,122.47,418957,323027,95930
2066-10,410506,19906,21653,14865,187051,115278,27063,12288,1879,1006,276.72,1,92.27,430412,378198,52214
2066-11,286536,45847,37245,14715,119111,124386,8052,34818,1031,3846,256.44,0,98.41,332383,338327,-5944
2066-12,323769,47132,29224,8380,199895,202216,29451,34565,3786,339,106.84,1,107.89,370901,503731,-132830
2067-01,266702,21754,28877,14620,127308,86721,22488,10566,1027,2831,272.72,0,84.58,288456,290580,-2124
2067-02,455221,41725,42504,6879,128619,193123,23144,23105,2676,3552,111.17,0,129.2,496946,417374,79572
2067-03,321935,42467,36342,13512,130659,185449,25153,14817,4358,1575,-7.71,1,135.59,364402,405932,-41530
2067-04,159718,48461,46615,11901,118763,219589,20079,15026,4987,1962,49.63,1,96.84,208179,431973,-223794
2067-05,361649,11153,29938,8582,159319,193557,21153,37720,3848,2544,77.02,0,104.27,372802,450269,-77467
2067-06,453104,43786,31074,13973,167304,83177,17239,17132,2341,3855,124.59,0,114.82,496890,329899,166991
2067-07,168689,17261,38799,11026,144374,51555,20065,31547,2370,1055,135.89,0,84.66,185950,297366,-111416
2067-08,231746,34197,44894,11742,103957,205863,7774,20779,2272,1624,66.75,1,139.45,265943,395009,-129066
2067-09,312697,16111,30294,8106,114781,135896,10189,11465,1423,1704,200.86,1,120.17,328808,310731,18077
2067-10,366821,38957,27601,13794,83439,209282,12826,37304,4260,3536,54.18,1,110.61,405778,384246,21532
2067-11,182951,13940,23041,11187,107545,175581,14406,20925,641,1245,241.07,0,83.64,196891,352685,-155794
2067-12,346623,24170,37386,14074,86454,236383,27103,31979,3382,2875,96.1,1,127.5,370793,433379,-62586
2068-01,381869,47639,29258,10138,190295,85869,16840,9380,2008,709,187.62,0,131.02,429508,341780,87728
2068-02,440458,39316,23074,11999,153080,75684,18023,8476,2086,2743,203.34,0,126.08,479774,290336,189438
2068-03,414026,23846,24616,13404,127049,212781,28835,32540,2398,3354,108.93,1,86.98,437872,439225,-1353
2068-04,432793,13637,31912,8038,102648,130712,10271,37060,644,3003,601.41,1,147.6,446430,320641,125789
2068-05,440154,19019,29569,11572,149225,130797,29356,27020,1160,3373,342.57,0,123.03,459173,377539,81634
2068-06,453336,26408,28199,6034,119987,165693,15331,26490,4003,2867,48.45,0,102.35,479744,361734,118010
2068-07,449348,46930,28598,12596,105281,138537,6187,29141,4993,457,139.14,0,127.88,496278,320340,175938
2068-08,151916,31573,42503,7730,195071,139700,6438,9606,2660,2035,-3.25,1,136.62,183489,401048,-217559
2068-09,255476,31550,23572,6268,143998,163758,24618,5251,680,2031,321.22,1,91.11,287026,367465,-80439
2068-10,204416,46779,24150,13470,188954,194204,9902,7865,3859,1974,25.19,1,120.21,251195,438545,-187350
2068-11,485278,17337,28474,11863,179071,242291,19325,25474,4306,3768,126.54,0,120.22,502615,506498,-3883
2068-12,196187,41465,36973,6073,111437,226491,18057,23865,4254,2384,45.98,1,144.83,237652,422896,-185244
2069-01,364953,20301,39723,6600,89714,241933,12051,17779,4693,2547,179.78,0,85.96,385254,407800,-22546
2069-02,120138,21574,49919,14569,142434,204464,29095,12080,4148,697,67.29,0,85.89,141712,452561,-310849
2069-03,217941,39277,24932,13139,146741,204855,15279,32303,2593,1075,-2.77,1,108.36,257218,437249,-180031
2069-04,331004,16948,25255,11287,147362,80977,5639,34923,1422,439,185.44,1,92.45,347952,305443,42509
2069-05,423611,41764,30607,12675,105233,180491,22940,29101,3982,2917,74.14,0,106.07,465375,381047,84328
2069-06,478757,35847,37387,5434,105462,52370,22564,37390,3411,2303,246.98,0,148.86,514604,260607,253997
2069-07,330687,36297,37755,14138,150943,171865,7572,15621,3617,882,97.26,0,128.5,366984,397894,-30910
2069-08,203765,34978,45228,6842,197562,180745,25625,33511,4762,826,44.04,1,147.0,238743,489513,-250770
2069-09,300914,46566,22008,6588,100354,188646,26477,29744,1979,3853,293.01,1,112.63,347480,373817,-26337
2069-10,330454,39131,48114,8048,105689,183780,17593,9861,3509,1882,107.15,1,105.64,369585,373085,-3500
2069-11,366471,12910,38221,13505,192740,132593,5449,31181,3092,1784,152.69,0,80.76,379381,413689,-34308
2069-12,287239,18353,23101,6123,111085,90536,16067,28665,3049,2068,128.13,1,147.82,305592,275577,30015
2070-01,311025,18429,22813,8169,161224,225916,14931,32672,1003,2733,331.25,0,106.48,329454,465725,-136271
2070-02,275446,15729,44938,8611,107348,160275,14304,23874,3203,2367,102.19,0,97.64,291175,359350,-68175
2070-03,118746,21619,32771,14548,127898,126532,14699,12637,3385,2849,7.29,1,97.05,140365,329085,-188720
2070-04,178104,34164,38727,11604,145732,228235,11474,20414,4290,1883,-7.67,1,94.99,212268,456186,-243918
2070-05,231782,35812,46517,8694,100884,172651,7515,18598,4790,548,-69.43,0,95.66,267594,354859,-87265
2070-06,142457,31505,44593,11544,100900,125299,14627,5593,749,3490,172.14,0,124.94,173962,302556,-128594
2070-07,117102,20901,24308,9607,186325,125982,8382,33638,4127,3902,17.57,0,131.67,138003,388242,-250239
2070-08,421786,11642,39550,8377,88177,197195,15330,8940,2051,1501,248.26,1,86.23,433428,357569,75859
2070-09,279605,24156,34214,6637,168224,98596,24673,34378,4117,3244,79.37,1,112.07,303761,366722,-62961
2070-10,338772,32384,39384,14744,89227,68624,17632,8262,3184,688,91.64,1,133.89,371156,237873,133283
2070-11,426084,43786,33480,10647,176847,126314,23832,10505,2267,2958,151.79,0,134.84,469870,381625,88245
2070-12,438888,28830,41646,10259,132777,234305,20731,34097,1414,303,378.92,1,124.87,467718,473815,-6097
2071-01,499015,37045,41042,6025,99904,60698,18855,34135,4478,3618,78.0,0,144.77,536060,260659,275401
2071-02,246984,19239,36076,11536,81560,197576,27917,16620,3823,3742,-20.36,0,141.88,266223,371285,-105062
2071-03,331407,29110,39230,14512,161104,247325,17572,12519,3494,1738,88.85,1,90.65,360517,492262,-131745
2071-04,381262,47064,31493,11094,128027,98996,5116,27790,3547,633,78.98,1,116.33,428326,302516,125810
2071-05,348805,49679,45147,8624,90070,243413,27771,7996,3726,2757,71.04,0,127.51,398484,423021,-24537
2071-06,293099,21909,40032,11241,89717,219450,29695,10980,701,3010,351.31,0,133.91,315008,401115,-86107
2071-07,129787,16194,27084,11013,188671,191715,22580,22518,1466,1170,134.62,0,86.93,145981,463581,-317600
2071-08,189810,44627,29138,9555,179767,177863,22894,14501,2241,1456,89.44,1,97.64,234437,433718,-199281
2071-09,210001,49849,22765,12437,122682,245319,26622,12249,3244,1418,89.72,1,105.56,259850,442074,-182224
2071-10,262648,22592,28137,13656,83700,85407,15939,7224,923,1716,274.76,1,113.13,285240,234063,51177
2071-11,313687,14573,47692,9930,123240,142632,12232,34897,2218,690,69.84,0,140.6,328260,370623,-42363
2071-12,440024,10078,46043,6907,157945,179308,28251,31354,1309,3686,365.04,1,137.89,450102,449808,294
2072-01,472608,42900,36313,5389,190688,62937,8758,15949,937,1813,379.9,0,101.96,515508,320034,195474
2072-02,391336,32060,47513,12625,123850,101316,25379,35345,1666,679,206.75,0,144.46,423396,346028,77368
2072-03,421559,20477,24006,7211,147176,121091,12109,29838,3625,2631,96.75,1,114.75,442036,341431,100605
2072-04,431419,21614,37612,13364,146208,214142,9771,23979,979,2394,434.95,1,132.72,453033,445076,7957
2072-05,115366,22950,31481,6672,169952,80503,24834,22432,2065,2528,101.47,0,139.87,138316,335874,-197558
2072-06,497761,15318,20610,10952,183412,103604,6108,12893,4497,796,90.67,0,124.7,513079,337579,175500
2072-07,140939,40107,29628,6337,83276,216637,29641,16491,1159,645,84.75,0,122.86,181046,382010,-200964
2072-08,116275,31655,22327,10024,143311,64984,5102,20699,1986,3996,13.7,1,94.76,147930,266447,-118517
2072-09,284833,22504,35463,5392,110940,174497,15547,37384,4494,514,81.34,1,102.52,307337,379223,-71886
2072-10,234549,48937,47984,10260,125801,98996,28162,12058,842,3551,340.17,1,145.76,283486,323261,-39775
2072-11,476757,11352,23896,11994,157946,178029,18309,30246,1172,2312,396.36,0,120.38,488109,420420,67689
2072-12,273533,22249,46496,13411,164069,69667,7498,9532,2657,1679,88.19,1,143.02,295782,310673,-14891
2073-01,196375,43170,29071,13979,147312,202654,23360,17149,3684,2404,84.64,0,80.24,239545,433525,-193980
2073-02,417299,29184,24204,10481,94579,70523,19800,15975,869,437,413.53,0,136.64,446483,235562,210921
2073-03,392107,25789,39691,7595,161217,200256,19257,17372,1261,776,248.7,1,143.37,417896,445388,-27492
2073-04,284549,34658,24900,6075,149047,140780,10049,21318,878,814,314.84,1,85.23,319207,352169,-32962
2073-05,412109,45011,37649,11164,199424,163109,8944,34095,2570,3170,108.59,0,138.38,457120,454385,2735
2073-06,141395,21893,34780,14212,192845,220916,5475,25503,659,1397,143.56,0,99.84,163288,493731,-330443
2073-07,129818,37502,33566,12704,120450,140098,14199,28004,2427,1231,46.98,0,109.9,167320,349021,-181701
2073-08,111449,30822,26137,13306,129018,174353,22000,9842,2536,3769,17.56,1,123.92,142271,374656,-232385
2073-09,432922,49099,39261,5116,157712,247091,28577,28898,2457,1062,178.79,1,83.88,482021,506655,-24634
2073-10,300072,42423,32945,7605,132136,119421,24468,28618,1353,3453,364.13,1,119.77,342495,345193,-2698
2073-11,295836,48008,23216,8013,164161,194757,22400,31718,4744,3188,68.1,0,138.75,343844,444265,-100421
2073-12,342409,13409,21682,11236,178041,91664,27882,21295,4097,2328,79.73,1,80.43,355818,351800,4018
2074-01,111673,43331,45235,14711,90014,130416,27782,16811,603,3024,247.41,0,110.51,155004,324969,-169965
2074-02,202025,22339,27329,6597,140023,86892,17567,29800,3777,2776,44.92,0,139.23,224364,308208,-83844
2074-03,136075,38672,28956,13848,190435,88572,16655,16765,1410,1173,202.56,1,86.98,174747,355231,-180484
2074-04,277255,30386,46774,7206,177159,184075,22893,15575,3058,1359,50.9,1,145.63,307641,453682,-146041
2074-05,494985,42556,38763,5065,129014,189199,18448,20648,4869,1110,82.11,0,92.37,537541,401137,136404
2074-06,222495,17840,21286,13810,156200,57300,16415,14101,2742,3661,82.73,0,114.11,240335,279112,-38777
2074-07,259196,21905,28937,5613,167293,199274,6472,10440,3039,3997,22.43,0,138.14,281101,418029,-136928
2074-08,385417,45612,29232,10834,161744,192809,13813,22712,861,1978,472.74,1,102.8,431029,431144,-115
2074-09,449290,28756,43316,6181,97008,232630,12883,9321,1947,1613,202.29,1,126.23,478046,401339,76707
2074-10,337062,42280,49645,12048,163817,105692,11069,34545,871,1315,329.66,1,122.93,379342,376816,2526
2074-11,335867,16033,26679,7073,154995,200467,12453,33694,3683,3094,77.05,0,119.65,351900,435361,-83461
2074-12,320460,20998,37688,12419,181867,200875,6049,11398,4242,3122,35.01,1,99.48,341458,450296,-108838
2075-01,463056,28856,48750,10986,144298,100012,10712,21520,508,2607,903.58,0,111.04,491912,336278,155634
2075-02,177222,13871,39814,11106,145643,95030,12747,23387,4277,486,57.26,0,108.74,191093,327727,-136634
2075-03,317881,34102,20563,8941,83116,219095,18895,22729,2870,3460,28.84,1,145.99,351983,373339,-21356
2075-04,332330,14696,20172,13036,152491,141186,21161,39934,1206,2514,309.07,1,123.24,347026,387980,-40954
2075-05,181706,21376,35993,10789,148337,237123,21639,39735,4029,2106,-1.71,0,116.45,203082,493616,-290534
2075-06,104697,15019,40012,12770,123198,144857,15677,38921,1373,878,60.74,0,140.15,119716,375435,-255719
2075-07,246423,17294,34198,11863,145222,230768,20727,26222,4557,1920,4.8,0,125.89,263717,469000,-205283
2075-08,206063,40036,26850,12894,155703,53637,15888,10081,2130,3263,51.08,1,88.64,246099,275053,-28954
2075-09,491587,29763,42454,8992,149020,84660,26075,13201,614,3428,787.16,1,93.9,521350,324402,196948
2075-10,409433,36351,33512,5984,182043,92778,14255,38745,4422,3490,7.1,1,94.71,445784,367317,78467
2075-11,159413,49983,37224,8855,142550,131243,26253,30659,1670,1100,77.33,0,101.41,209396,376784,-167388
2075-12,453442,29292,30923,8169,198183,234580,24330,28241,1313,3392,435.56,1,130.8,482734,524426,-41692
2076-01,326888,39798,31523,7443,144998,226366,5251,29679,964,2661,341.28,0,124.51,366686,445260,-78574
2076-02,406355,35262,44998,7486,120644,240333,5013,15121,4358,1436,99.02,0,121.97,441617,433595,8022
2076-03,129070,32149,29801,5880,111478,200424,26445,14782,3309,3626,85.35,1,108.77,161219,388810,-227591
2076-04,105657,29493,22379,14923,168601,131942,11610,28738,1749,1985,-20.18,1,96.25,135150,378193,-243043
2076-05,276306,11016,36922,8390,188774,247552,15844,10610,4290,3921,54.04,0,129.46,287322,508092,-220770
2076-06,204941,23342,21905,8071,120182,173560,5034,34127,979,642,233.23,0,137.07,228283,362879,-134596
2076-07,320702,11174,34454,8368,194859,157922,23264,19124,663,2255,483.51,0,92.91,331876,437991,-106115
2076-08,114714,24937,47102,6689,197537,125334,28866,9082,2237,2040,127.38,1,110.82,139651,414610,-274959
2076-09,243829,36660,35527,14008,87740,114183,5697,22299,1590,336,165.23,1,128.11,280489,279454,1035
2076-10,321223,47730,37733,6445,137863,176599,13670,35472,2665,3541,89.7,1,126.17,368953,407782,-38829
2076-11,495742,33323,43559,6175,102073,165428,28865,5085,1439,386,384.02,0,125.99,529065,351185,177880
2076-12,277913,18632,49101,7326,142320,77628,21267,36461,1166,1029,171.99,1,98.49,296545,334103,-37558
2077-01,329656,13662,33368,14049,166122,109526,10725,24098,4686,1154,38.79,0,106.0,343318,357888,-14570
2077-02,172838,13334,41020,14413,80262,119134,8774,39394,3073,3614,26.56,0,82.07,186172,302997,-116825
2077-03,449955,42584,30202,8896,179936,87195,28253,21272,2403,2007,138.12,1,97.38,492539,355754,136785
2077-04,254717,40105,41031,11905,124968,150525,19697,25776,3369,2372,87.35,1,125.99,294822,373902,-79080
2077-05,114926,47054,25671,14932,161622,184281,18721,7855,2509,2640,121.53,0,101.58,161980,413082,-251102
2077-06,436704,42542,23499,7515,137794,238725,29088,19855,1334,983,305.03,0,83.56,479246,456476,22770
2077-07,150024,41644,27208,11116,82685,97654,7815,23545,1958,2733,78.69,0,129.39,191668,250023,-58355
2077-08,415904,40935,39685,11093,145296,156707,19048,22791,4584,1673,69.89,1,130.32,456839,394620,62219
2077-09,451563,14953,21469,14424,116565,100938,24559,21256,4927,1856,111.51,1,116.26,466516,299211,167305
2077-10,455981,25386,37731,13455,89715,213284,5986,14320,3823,3135,228.66,1,122.42,481367,374491,106876
2077-11,165775,17129,40073,14211,114691,92520,11384,5934,1295,2035,130.47,0,123.9,182904,278813,-95909
2077-12,472764,30340,20704,9989,159329,184636,7664,25323,4303,2412,68.56,1,117.11,503104,407645,95459
2078-01,120971,26649,35224,14961,82814,240264,9826,13394,582,2572,123.66,0,89.66,147620,396483,-248863
2078-02,442032,10343,34589,5254,153860,205473,6080,24958,4561,2693,167.54,0,94.75,452375,430214,22161
2078-03,396189,10159,37135,11145,163642,195833,24735,39314,1383,1374,236.49,1,127.59,406348,471804,-65456
2078-04,156729,27911,33667,8529,166765,178485,21094,8863,4522,3550,-116.73,1,110.91,184640,417403,-232763
2078-05,229052,31518,20341,10696,178656,118277,6863,13563,4827,970,20.67,0,145.38,260570,348396,-87826
2078-06,123054,22370,29876,13959,132202,58325,11156,10174,2281,3827,89.52,0,130.94,145424,255692,-110268
2078-07,152966,41906,39243,6328,122661,152692,14707,12682,3278,1685,80.85,0,143.39,194872,348313,-153441
2078-08,387942,18401,23907,12969,166414,222611,16647,14111,2361,3077,100.29,1,99.01,406343,456659,-50316
2078-09,422669,47721,32110,14897,150881,50901,13665,18854,778,3645,481.05,1,132.98,470390,281308,189082
2078-10,467524,24199,27165,8749,103116,72918,19767,6526,2084,1832,116.79,1,105.03,491723,238241,253482
2078-11,142061,46583,33110,7182,105598,180529,5589,20451,3771,1624,-79.22,0,127.49,188644,352459,-163815
2078-12,314397,19707,36236,7902,102268,168578,24425,30234,2592,3637,184.47,1,118.97,334104,369643,-35539
2079-01,225697,30665,40904,14787,96871,58289,24542,36709,1255,1608,142.4,0,105.63,256362,272102,-15740
2079-02,435116,17384,24385,8564,138294,235459,14004,38932,4639,1618,104.03,0,98.29,452500,459638,-7138
2079-03,216869,36033,31032,13773,177067,134116,20863,9011,2251,2776,179.84,1,94.37,252902,385862,-132960
2079-04,414708,36762,33635,8469,91251,198198,14508,15551,1525,2620,227.58,1,142.87,451470,361612,89858
2079-05,100049,30475,28782,10284,100025,213539,8544,36553,810,3222,180.93,0,111.02,130524,397727,-267203
2079-06,383001,46700,33688,11626,142374,118173,29501,35153,2242,1584,253.82,0,115.05,429701,370515,59186
2079-07,493319,12500,20837,6485,115811,221758,5496,5359,1393,2483,359.68,0,126.67,505819,375746,130073
2079-08,382915,14733,45903,11504,95908,180071,25646,38376,1647,3858,220.4,1,98.39,397648,397408,240
2079-09,136084,16121,35300,9032,182522,180573,28368,33282,4897,1177,55.56,1,147.85,152205,469077,-316872
2079-10,260579,12354,27385,12784,155966,242088,11265,36946,2881,837,44.58,1,104.53,272933,486434,-213501
2079-11,168935,12947,31935,12052,80729,179652,28749,12287,2758,1208,99.02,0,107.01,181882,345404,-163522
2079-12,104560,11338,34675,13822,103611,144969,25480,29936,2349,2147,29.47,1,109.88,115898,352493,-236595
2080-01,297300,14679,23951,14340,169607,225704,25109,19026,2704,3848,81.7,0,104.89,311979,477737,-165758
2080-02,250214,28388,44838,8352,157446,53650,24273,15745,1673,2505,83.15,0,112.84,278602,304304,-25702
2080-03,403384,22992,24642,5364,178300,146983,20838,10554,4590,2527,107.8,1,132.23,426376,386681,39695
2080-04,282238,24828,39204,13912,154262,222280,9602,9987,3224,3581,33.21,1,91.57,307066,449247,-142181
2080-05,368997,22042,42519,13340,132957,207716,15986,29007,2868,2031,96.34,0,101.55,391039,441525,-50486
2080-06,332880,30222,43347,14266,196295,83653,23253,20939,648,1951,469.43,0,117.36,363102,381753,-18651
2080-07,489591,49073,23011,14677,95775,144808,21511,11514,3275,501,100.04,0,119.56,538664,311296,227368
2080-08,393872,48681,33772,8164,90550,115593,20900,36747,737,1985,659.23,1,102.32,442553,305726,136827
2080-09,243094,41019,21397,9566,85467,111402,12072,15934,4027,3401,35.23,1,109.6,284113,255838,28275
2080-10,258057,12574,29494,9600,120779,223579,20363,35926,2311,1274,115.84,1,116.91,270631,439741,-169110
2080-11,107692,43275,49365,13565,104562,68562,21513,5632,4245,2851,35.17,0,134.13,150967,263199,-112232
2080-12,222683,14932,33360,11952,84354,195861,10765,22972,4036,2263,54.59,1,129.26,237615,359264,-121649
2081-01,217050,44628,42875,6110,84273,134336,8599,31689,4566,3184,94.21,0,113.81,261678,307882,-46204
2081-02,324159,36281,37394,9351,117101,123421,5580,7654,1082,1993,323.02,0,83.87,360440,300501,59939
2081-03,198990,28169,34057,9529,86611,212558,6559,9036,4303,581,65.62,1,113.66,227159,358350,-131191
2081-04,253911,11983,49568,9099,166636,138370,15944,12409,2265,1021,162.13,1,146.15,265894,392026,-126132
2081-05,406790,24305,37992,6604,189910,235773,13284,6314,2706,560,93.35,0,121.68,431095,489877,-58782
2081-06,184215,45567,42710,6458,126716,165809,19209,7533,2653,1955,128.64,0,141.28,229782,368435,-138653
2081-07,236706,26116,48235,10962,81354,129620,5082,6307,1646,1485,89.85,0,87.64,262822,281560,-18738
2081-08,355440,28329,44030,6109,191351,67583,14729,27450,2069,3688,167.44,1,95.67,383769,351252,32517
2081-09,276491,27031,49849,9754,108455,148470,20938,27250,1367,905,109.26,1,125.01,303522,364716,-61194
2081-10,367669,44079,42772,11256,122256,127968,16474,34181,1927,3177,196.19,1,89.63,411748,354907,56841
2081-11,472941,45237,37050,7646,101620,157299,26083,5979,3991,1714,68.39,0,132.67,518178,335677,182501
2081-12,478203,17871,47852,11371,108366,149105,13690,6756,2100,3675,167.91,1,104.01,496074,337140,158934
2082-01,478175,23644,42890,5429,185591,120642,24033,31267,1352,1459,333.94,0,92.29,501819,409852,91967
2082-02,437919,39652,43885,7944,88805,204110,9542,36073,1653,2385,371.37,0,133.75,477571,390359,87212
2082-03,294676,39353,46074,5509,159711,247732,18662,34544,4043,3047,63.18,1,123.63,334029,512232,-178203
2082-04,403139,25744,31777,6132,128110,225994,7017,32766,2580,3580,150.1,1,117.61,428883,431796,-2913
2082-05,490183,28252,47322,6060,198632,211152,14756,16939,1942,674,226.97,0,107.08,518435,494861,23574
2082-06,256908,20549,45798,8366,102214,142285,19764,13421,3954,2377,90.17,0,116.87,277457,331848,-54391
2082-07,421201,41796,32976,13185,163320,153899,13027,35915,3648,1356,158.11,0,106.14,462997,412322,50675
2082-08,315494,15856,44582,10095,87134,109579,20019,11681,2635,1115,146.55,1,108.88,331350,283090,48260
2082-09,451580,26507,49907,7795,109622,245284,11163,22480,3764,3072,119.14,1,94.51,478087,446251,31836
2082-10,494244,11860,21181,12559,199518,109217,6565,14816,3352,3677,43.81,1,111.7,506104,363856,142248
2082-11,247063,38312,48243,9032,146009,165184,17382,27881,1147,3933,219.11,0,96.77,285375,413731,-128356
2082-12,215864,44144,22271,8314,127894,94073,13216,11011,2296,479,18.48,1,115.14,260008,276779,-16771
2083-01,239143,29445,21478,13747,176432,220265,29941,19367,752,1266,312.02,0,100.7,268588,481230,-212642
2083-02,208972,34954,38622,9176,190937,170777,27740,32057,2564,634,19.24,0,123.28,243926,469309,-225383
2083-03,105299,15471,32189,5191,143229,223628,13336,36323,3150,1434,46.21,1,114.86,120770,453896,-333126
2083-04,442788,14328,22670,14052,132117,213691,21467,29699,3947,1647,75.08,1,85.31,457116,433696,23420
2083-05,324684,12980,34088,6920,151230,129023,25304,13198,614,1560,595.68,0,103.51,337664,359763,-22099
2083-06,498264,11675,37817,12068,194311,124038,28437,11508,4091,842,136.84,0,89.09,509939,408179,101760
2083-07,365075,27041,25909,13845,80759,144127,16690,31449,4427,3224,91.97,0,142.57,392116,312779,79337
2083-08,157776,22999,41906,8387,123467,104087,7708,25931,4427,1136,100.69,1,128.94,180775,311486,-130711
2083-09,343326,48310,24679,9441,101678,155990,12010,22989,813,1341,337.85,1,101.94,391636,326787,64849
2083-10,437562,45122,32833,9956,156072,158085,22902,17215,944,2054,482.95,1,142.22,482684,397063,85621
2083-11,202919,21226,22919,14383,86435,229743,19931,6841,2413,3697,57.81,0,110.7,224145,380252,-156107
2083-12,440653,19806,34736,8162,176987,249332,5579,13543,989,3289,400.6,1,136.6,460459,488339,-27880
2084-01,376663,18302,22577,13439,158279,94469,12741,25384,2032,1153,154.41,0,130.99,394965,326889,68076
2084-02,362302,33328,40727,11260,115632,208075,11610,16450,1739,3627,235.96,0,113.85,395630,403754,-8124
2084-03,300606,23901,33743,7181,131132,120969,17638,8071,4481,2603,38.87,1,116.61,324507,318734,5773
2084-04,172091,21162,31813,12368,91925,160007,27400,20902,2037,3916,42.4,1,142.29,193253,344415,-151162
2084-05,323067,41206,41839,14769,193622,231784,16145,7685,1364,732,289.83,0,108.22,364273,505844,-141571
2084-06,180555,27459,28835,11982,173712,172653,23692,29962,3927,3618,42.75,0,146.92,208014,440836,-232822
2084-07,446283,38844,48409,9561,104590,216537,22787,24273,2711,3424,184.57,0,80.23,485127,426157,58970
2084-08,125089,43462,21473,5194,144107,143975,15815,31798,940,2437,161.22,1,106.98,168551,362362,-193811
2084-09,391505,48502,32400,12243,121287,129943,27598,26751,1642,1903,141.53,1,139.28,440007,350222,89785
2084-10,455249,45596,36963,10169,80046,69111,7659,19421,1289,988,352.26,1,148.36,500845,223369,277476
2084-11,408788,46957,29449,5495,121852,90895,29160,8467,2220,3549,77.16,0,85.52,455745,285318,170427
2084-12,171386,38465,32276,14553,143702,240409,21451,18281,4976,775,68.66,1,118.51,209851,470672,-260821
2085-01,462977,13480,44346,9508,199021,87761,25324,14254,1207,3915,428.48,0,95.86,476457,380214,96243
2085-02,103678,47893,42748,12731,93893,233018,15043,25018,3894,875,24.13,0,135.54,151571,422451,-270880
2085-03,491228,22671,23463,6133,189971,217848,16253,6276,2321,1153,254.46,1,80.72,513899,459944,53955
2085-04,351580,22571,41740,6233,83349,141319,25617,28020,4458,852,6.75,1,93.69,374151,326278,47873
2085-05,315901,11863,46770,5544,97881,191344,16601,28475,1767,2522,244.05,0,114.86,327764,386615,-58851
2085-06,212903,10137,34748,14116,188066,184989,17931,16329,3482,1001,96.62,0,120.51,223040,456179,-233139
2085-07,495809,20561,35291,10389,169035,213747,5411,36066,3522,2411,120.57,0,127.04,516370,469939,46431
2085-08,435048,24829,37218,13359,146427,102354,26731,17910,2655,3383,214.0,1,135.09,459877,343999,115878
2085-09,153726,29900,28267,11117,175792,57436,20924,14781,737,3876,217.25,1,100.22,183626,308317,-124691
2085-10,297130,47260,25366,7633,101679,237847,22613,18011,1825,1339,241.23,1,117.82,344390,413149,-68759
2085-11,377641,41726,27601,7953,146638,245143,24915,19144,1833,2973,82.56,0,109.39,419367,471394,-52027
2085-12,150959,44404,33119,7636,177661,202090,5451,14875,2986,745,93.23,1,91.54,195363,440832,-245469
2086-01,368492,45081,25487,8246,174346,204190,9210,14028,1893,3514,237.44,0,94.59,413573,435507,-21934
2086-02,491799,17228,22040,10341,127597,175151,9563,15372,3018,2864,244.76,0,88.82,509027,360064,148963
2086-03,238559,36697,20126,7036,82161,127115,16742,30198,3489,2951,93.04,1,121.34,275256,283378,-8122
2086-04,390448,34552,26105,9417,156960,144177,8526,14795,1600,1591,176.41,1,105.84,425000,359980,65020
2086-05,113240,22106,39477,7209,128640,225345,15594,21340,3242,1366,-13.22,0,93.3,135346,437605,-302259
2086-06,122572,22670,48497,12316,94546,210097,15236,9085,3527,3130,78.93,0,92.72,145242,389777,-244535
2086-07,303868,30459,44462,8220,174255,124811,8667,34844,4027,3402,118.27,0,97.4,334327,395259,-60932
2086-08,143179,33469,29727,7703,147479,210846,27428,28644,2682,3800,65.41,1,141.34,176648,451827,-275179
2086-09,365659,31762,37470,12529,111792,194471,5706,29820,2369,1669,163.02,1,102.61,397421,391788,5633
2086-10,177349,17218,43946,5765,100898,128779,29107,20435,1071,2535,195.02,1,125.87,194567,328930,-134363
2086-11,484231,27669,45346,8898,122891,58782,28689,12971,3546,1362,121.78,0,131.47,511900,277577,234323
2086-12,280893,45768,31100,14533,193594,130653,28458,27205,2327,3070,24.75,1,94.51,326661,425543,-98882
2087-01,462266,23809,49750,5524,153849,174671,16045,22205,2167,2227,354.1,0,100.23,486075,422044,64031
2087-02,244774,46679,32066,8766,162154,227482,10172,19506,2043,1139,155.8,0,107.5,291453,460146,-168693
2087-03,229999,15521,47107,11413,158307,242622,23970,15112,921,3867,301.33,1,122.82,245520,498531,-253011
2087-04,156006,33134,32810,8191,84631,222849,6379,24376,746,2353,236.64,1,103.75,189140,379236,-190096
2087-05,392617,30183,41060,6681,156449,204809,16801,31699,3391,1426,9.96,0,122.51,422800,457499,-34699
2087-06,484972,25067,29553,9670,177521,235867,22026,13215,3024,923,111.03,0,97.96,510039,487852,22187
2087-07,407377,11994,49704,5137,168555,58350,28495,24188,864,1470,512.23,0,104.66,419371,334429,84942
2087-08,157300,22591,23603,9949,151731,134464,7469,7498,1830,1045,56.12,1,118.71,179891,334714,-154823
2087-09,274664,38452,23509,9642,172183,115786,17911,31319,2968,2296,52.48,1,128.13,313116,370350,-57234
2087-10,109708,16813,20151,12292,199831,115001,25687,39809,2875,907,-122.28,1,139.6,126521,412771,-286250
2087-11,336599,21451,43225,11240,93315,141105,24298,33368,4477,906,73.1,0,97.59,358050,346551,11499
2087-12,102225,10338,42680,5181,184669,114543,11680,36086,3876,3497,-28.07,1,110.53,112563,394839,-282276
2088-01,145082,18508,37039,9968,170922,136109,12386,15327,3035,2356,-14.75,0,90.3,163590,381751,-218161
2088-02,416978,36794,21916,5986,80322,115852,19583,38088,2837,3396,100.41,0,116.0,453772,281747,172025
2088-03,439422,36871,35434,5820,120210,206197,6456,15698,1606,3330,214.08,1,132.79,476293,389815,86478
2088-04,464984,14201,22548,12892,90208,184016,8261,9702,3596,446,115.89,1,137.79,479185,327627,151558
2088-05,421907,23663,29860,14992,195384,218199,28247,10352,2346,965,153.39,0,87.86,445570,497034,-51464
2088-06,127706,38111,21041,5783,150418,129496,29390,34282,3965,880,90.32,0,94.62,165817,370410,-204593
2088-07,200350,26995,32510,6748,86015,76668,14088,17243,3053,720,43.21,0,86.35,227345,233272,-5927
2088-08,271961,24124,48738,9947,131646,68298,5431,22657,3805,807,44.37,1,92.9,296085,286717,9368
2088-09,249726,16182,20504,10327,97757,126095,12813,7951,2446,3331,113.19,1,87.12,265908,275447,-9539
2088-10,497360,11915,32803,14116,101187,57101,20401,17254,4500,2117,154.16,1,105.15,509275,242862,266413
2088-11,479988,16545,44534,9243,118270,123320,27985,26856,1386,1193,233.44,0,126.47,496533,350208,146325
2088-12,426403,46756,33052,9023,80655,117177,20750,19824,2305,458,207.05,1,139.59,473159,280481,192678
2089-01,137133,37308,34535,8446,157678,206602,12455,37348,2936,614,32.69,0,94.48,174441,457064,-282623
2089-02,142144,27516,45628,7048,189899,147356,8775,28490,2304,3736,-42.71,0,125.34,169660,427196,-257536
2089-03,425840,41474,31975,7177,105503,241885,6261,19520,2379,2860,139.57,1,137.83,467314,412321,54993
2089-04,285949,23500,24987,7639,155246,223662,22621,14254,711,3907,367.42,1,128.25,309449,448409,-138960
2089-05,333073,15983,29561,9663,131477,194544,14284,32077,1364,919,220.51,0,132.61,349056,411606,-62550
2089-06,118647,44731,29022,8820,86391,149940,29889,26119,3566,2540,63.1,0,95.68,163378,330181,-166803
2089-07,436253,18576,20708,9713,185907,219967,5397,10881,2150,2599,219.58,0,149.1,454829,452573,2256
2089-08,401471,11411,34198,11186,144591,249237,8735,5957,3914,554,110.31,1,98.69,412882,453904,-41022
2089-09,366226,25564,37724,9431,125651,189166,12145,11012,1014,1672,267.63,1,93.67,391790,385129,6661
2089-10,206515,40791,44503,7853,192172,79918,5220,7079,1376,2541,280.86,1,94.85,247306,336745,-89439
2089-11,397800,17825,41748,13035,107965,66063,13892,27359,2746,2938,133.26,0,142.07,415625,270062,145563
2089-12,112831,36984,36411,6332,186924,61223,28234,36159,2658,340,-45.53,1,128.59,149815,355283,-205468
2090-01,152477,33389,43312,14866,108410,187542,13404,6549,4992,1045,108.18,0,84.41,185866,374083,-188217
2090-02,475220,29099,37139,13184,129274,187422,7377,22051,1473,3682,348.18,0,89.76,504319,396447,107872
2090-03,472782,17255,26751,8127,133726,147293,13595,7843,963,3167,491.94,1,128.85,490037,337335,152702
2090-04,357478,39197,20973,6513,135001,136535,24221,34332,4275,1184,51.77,1,137.79,396675,357575,39100
2090-05,268245,40019,41392,11915,199662,239915,29214,6150,2652,1259,157.57,0,107.62,308264,528248,-219984
2090-06,361717,26042,24581,12410,178134,59617,13050,38471,2637,1804,153.4,0,103.32,387759,326263,61496
2090-07,388768,22945,35808,13117,95781,169131,11652,37350,3685,1936,120.97,0,126.59,411713,362839,48874
2090-08,387120,45116,36850,12295,185029,81223,13626,19909,1902,3028,153.51,1,111.42,432236,348932,83304
2090-09,492663,32397,32218,13665,119507,147930,23445,19630,2663,1091,134.67,1,124.26,525060,356395,168665
2090-10,222982,13007,49553,6078,131256,81676,25779,34406,1792,2361,158.28,1,130.48,235989,328748,-92759
2090-11,119808,41991,22528,12661,149634,129487,28120,22936,3536,2650,113.14,0,87.42,161799,365366,-203567
2090-12,124395,27829,28536,8345,136425,117881,11972,23202,4036,1421,-10.27,1,134.61,152224,326361,-174137
2091-01,249381,36404,44987,11179,120601,85642,14339,39724,3941,846,66.5,0,136.98,285785,316472,-30687
2091-02,136651,33785,24516,10606,172693,197864,12637,8313,544,1563,287.52,0,100.53,170436,426629,-256193
2091-03,341099,16737,23305,12864,180473,177928,28893,8611,4717,3636,128.11,1,100.3,357836,432074,-74238
2091-04,437430,12891,37166,6806,154614,182888,24221,11980,2325,595,206.93,1,100.54,450321,417675,32646
2091-05,321390,25080,26742,10797,115772,227666,26576,25761,3752,3086,101.16,0,149.02,346470,433314,-86844
2091-06,242577,16987,20077,12725,100879,151764,18080,37882,4719,2928,-42.14,0,127.03,259564,341407,-81843
2091-07,256964,30536,48889,13476,173330,189743,25264,20167,2846,3595,60.18,0,134.21,287500,470869,-183369
2091-08,171214,29790,45820,9923,140938,53495,7824,36064,3922,2910,165.86,1,139.28,201004,294064,-93060
2091-09,305856,12521,47691,8315,91051,225056,20960,17288,2631,3746,142.9,1,110.85,318377,410361,-91984
2091-10,154569,33049,25998,10643,169883,187845,10828,9671,4071,1687,102.85,1,95.34,187618,414868,-227250
2091-11,182246,28952,36270,13618,80563,81092,23330,24490,3098,405,12.7,0,91.56,211198,259363,-48165
2091-12,143647,13966,22884,10322,180268,69541,18584,39929,3336,1769,-1.89,1,101.7,157613,341528,-183915
2092-01,267242,10156,28091,10383,158060,90870,21776,20779,4394,3892,149.51,0,127.84,277398,329959,-52561
2092-02,100687,15021,33640,6438,90061,73641,27266,19176,3085,2735,30.37,0,125.61,115708,250222,-134514
2092-03,438147,30836,38786,6706,162480,113497,13402,25875,2666,3142,138.34,1,134.25,468983,360746,108237
2092-04,406977,35849,21062,12800,174512,144882,7593,7200,2821,3286,186.71,1,122.13,442826,368049,74777
2092-05,340807,40371,25859,11654,161062,81895,28809,13642,3302,3255,132.88,0,126.9,381178,322921,58257
2092-06,451340,45795,32044,9461,137225,73395,23204,5771,4132,3574,67.51,0,126.63,497135,281100,216035
2092-07,280692,34636,40223,7297,84283,183056,26904,18459,1588,1541,154.43,0,100.38,315328,360222,-44894
2092-08,448975,49191,20526,7715,199781,168679,21333,23330,2227,3726,231.17,1,146.74,498166,441364,56802
2092-09,310559,11179,28020,8065,140228,150095,29723,28841,1857,1144,115.91,1,102.63,321738,384972,-63234
2092-10,494283,42735,28869,12217,117459,149527,27386,5792,4858,2619,69.13,1,134.24,537018,341250,195768
2092-11,174536,16460,38727,12803,140845,145779,25235,6233,641,2285,265.23,0,134.84,190996,369622,-178626
2092-12,420072,22436,35331,12094,134320,199588,16723,6986,3134,2848,184.18,1,125.63,442508,405042,37466
2093-01,391279,39978,31295,7705,91263,131693,27003,8546,4943,2968,46.06,0,137.04,431257,297505,133752
2093-02,229478,46061,23801,9095,152622,210183,26699,23921,3759,2772,112.17,0,131.87,275539,446321,-170782
2093-03,200667,20607,32542,6238,177390,149689,21458,13799,1725,3913,137.66,1,146.98,221274,401116,-179842
2093-04,356295,40539,21312,8454,104973,217014,8002,27928,1178,1117,356.27,1,136.51,396834,387683,9151
