Month-Year,Sales Revenue (₹),Service Fees (₹),Rent (₹),Utilities (₹),Salaries & Wages (₹),Raw Materials / Inventory (₹),Transportation / Logistics (₹),Loan Repayments & Interest (₹),Number of Orders,Customers,Average Order Value,Seasonality_Flag,Fuel Price Index,Total Income (₹),Total Expenses (₹),Net Cash Flow (₹)
2010-01,307621,48036,23650,10962,149549,165969,23878,37293,3928,963,-0.9,0,144.07,355657,411301,-55644
2010-02,398468,13159,21214,14273,153603,138625,15968,22483,2588,1230,202.5,0,85.53,411627,366166,45461
2010-03,405073,42745,37257,8132,177119,152835,18315,33314,4987,2339,155.34,1,101.82,447818,426972,20846
2010-04,246436,13913,24126,12684,119663,173221,9061,24696,1970,729,122.39,1,122.37,260349,363451,-103102
2010-05,286890,12864,21973,10094,177444,97558,6660,23925,3139,573,128.1,0,131.24,299754,337654,-37900
2010-06,357734,12095,49378,8460,172650,205871,6437,10384,4947,1704,116.25,0,81.67,369829,453180,-83351
2010-07,175879,44004,21540,8548,199655,246936,21402,17550,3780,2359,31.11,0,130.42,219883,515631,-295748
2010-08,117699,27829,23814,9046,188330,179729,5110,39968,4356,2544,-42.02,1,122.38,145528,445997,-300469
2010-09,186559,44999,35515,12692,178939,126905,9691,21497,2903,719,112.49,1,126.71,231558,385239,-153681
2010-10,218872,22615,49967,6059,95715,238809,28196,5317,1961,3254,150.96,1,146.11,241487,424063,-182576
2010-11,485621,16492,34510,6891,87688,199619,14444,28167,2608,1182,117.16,0,130.59,502113,371319,130794
2010-12,214164,18309,29722,13841,108035,226770,27257,30054,4329,2449,112.11,1,86.31,232473,435679,-203206
2011-01,228975,23894,43660,6582,95297,205229,11385,6066,657,1478,405.18,0,90.45,252869,368219,-115350
2011-02,101260,27164,35294,13779,176565,108803,21726,11872,2284,1901,82.31,0,139.56,128424,368039,-239615
2011-03,313073,17795,48206,11935,101689,215556,21231,33505,4757,1522,33.5,1,80.52,330868,432122,-101254
2011-04,261828,28822,37944,10311,82604,92760,17374,8176,3023,954,92.42,1,85.27,290650,249169,41481
2011-05,234972,16961,21601,11955,101524,158183,20193,30490,846,2105,245.22,0,133.27,251933,343946,-92013
2011-06,446165,14213,33361,6907,133960,232526,6976,18895,1544,2190,295.69,0,113.54,460378,432625,27753
2011-07,481451,25759,29029,13846,107306,67557,12388,10588,2972,543,175.87,0,126.3,507210,240714,266496
2011-08,417044,25614,49547,14884,128230,196320,10901,9636,3479,733,211.47,1,94.03,442658,409518,33140
2011-09,252830,47882,42811,14327,170852,247695,25721,9000,2609,2742,105.44,1,147.51,300712,510406,-209694
2011-10,359059,39314,42787,14078,191750,75464,15499,32056,845,880,329.18,1,99.06,398373,371634,26739
2011-11,497669,14695,30576,7348,135757,152614,9576,36057,3694,3196,210.99,0,113.37,512364,371928,140436
2011-12,427605,26242,37203,12099,156920,196700,5620,18126,4570,856,134.87,1,138.16,453847,426668,27179
2012-01,418644,15515,27930,7705,83808,170068,8988,17807,2772,2229,68.33,0,134.7,434159,316306,117853
2012-02,245606,39103,49274,14950,108263,82402,19463,34764,996,1683,336.66,0,136.21,284709,309116,-24407
2012-03,272669,46226,20491,11328,196169,85921,22719,17201,1933,2728,154.42,1,97.02,318895,353829,-34934
2012-04,153797,13349,38488,13132,164394,247692,8978,19537,2769,1524,85.8,1,114.85,167146,492221,-325075
2012-05,476766,49443,22658,10149,113429,75030,17407,14836,2843,2494,102.49,0,115.66,526209,253509,272700
2012-06,222577,29795,23560,9821,177253,183050,17921,9277,2467,3749,59.07,0,122.91,252372,420882,-168510
2012-07,460486,48626,46592,9109,96937,128733,26119,33720,4757,2507,192.87,0,89.5,509112,341210,167902
2012-08,232524,48411,37591,11073,142180,50089,23189,30035,688,433,338.73,1,131.46,280935,294157,-13222
2012-09,285460,29376,27235,9078,92942,66094,23408,37667,3398,785,103.63,1,136.47,314836,256424,58412
2012-10,358925,11676,21661,8880,133172,111986,5845,12412,2024,327,218.83,1,120.67,370601,293956,76645
2012-11,208058,29490,25003,11516,187549,136967,24529,26444,3815,2985,55.86,0,138.94,237548,412008,-174460
2012-12,352048,22813,25811,13306,177059,71219,22077,33575,3521,2325,131.9,1,131.71,374861,343047,31814
2013-01,299070,36681,29800,14503,196518,53832,9095,20498,4308,3010,136.95,0,134.18,335751,324246,11505
2013-02,317919,39888,32208,7544,115200,96267,21398,8916,805,566,337.93,0,141.76,357807,281533,76274
2013-03,360441,48329,21742,8169,87534,61237,16203,28719,4542,1603,75.16,1,82.09,408770,223604,185166
2013-04,214922,48997,46314,5387,96911,222324,8155,15697,4511,786,105.65,1,93.74,263919,394788,-130869
2013-05,429604,18738,49265,11568,103211,223080,11147,26331,4733,3898,170.58,0,87.22,448342,424602,23740
2013-06,257761,43599,31850,7374,138935,206768,19894,30956,3873,3493,85.27,0,96.53,301360,435777,-134417
2013-07,338363,38187,22774,13640,128242,190561,7419,9211,3319,1683,103.49,0,114.87,376550,371847,4703
2013-08,229728,39952,49678,5542,109641,157136,6296,38678,3134,2328,82.7,1,141.7,269680,366971,-97291
2013-09,210717,13363,22113,13962,127503,174770,16798,25335,2896,382,33.45,1,107.4,224080,380481,-156401
2013-10,111143,27803,42171,13695,82864,133245,24869,36174,587,1665,217.15,1,148.07,138946,333018,-194072
2013-11,248447,45675,25789,6819,94678,226515,6557,16625,1117,1789,269.28,0,95.22,294122,376983,-82861
2013-12,102421,34837,44917,13170,111886,107962,19254,29761,1302,2721,39.85,1,119.29,137258,326950,-189692
2014-01,425603,39661,22843,14853,107327,129846,6362,13691,2474,2769,154.78,0,95.65,465264,294922,170342
2014-02,455316,11590,49507,9372,93114,155648,14778,11983,3077,1628,124.6,0,93.45,466906,334402,132504
2014-03,427784,35219,21220,11700,82034,171533,9861,23067,1662,3833,278.56,1,129.19,463003,319415,143588
2014-04,395220,45788,27525,5442,167266,140945,20724,27886,3109,3895,124.62,1,141.89,441008,389788,51220
2014-05,262998,39822,39178,11590,186404,136611,11130,38302,4841,1432,122.95,0,113.07,302820,423215,-120395
2014-06,324576,24633,39635,11167,104644,81341,15994,37203,1629,902,221.78,0,132.55,349209,289984,59225
2014-07,321878,26888,32456,5823,159031,148166,26552,38729,2402,1330,54.62,0,85.28,348766,410757,-61991
2014-08,370374,49506,35699,10539,149786,91362,8760,22462,3319,945,77.47,1,91.79,419880,318608,101272
2014-09,409194,32562,35972,6958,133341,92286,14956,32084,3110,389,128.33,1,103.46,441756,315597,126159
2014-10,287448,47591,35103,9814,121699,240544,17431,22082,2471,3164,144.28,1,87.35,335039,446673,-111634
2014-11,108683,49084,30329,7145,188900,168070,6291,21874,4818,1274,15.61,0,127.09,157767,422609,-264842
2014-12,143236,22677,24139,9884,194101,189085,29570,39500,907,3531,84.33,1,133.89,165913,486279,-320366
2015-01,484823,22005,42774,9859,177514,109567,24359,32023,1914,3920,303.62,0,122.8,506828,396096,110732
2015-02,115801,13791,21892,6178,97120,237768,7926,26612,4798,2862,64.09,0,149.48,129592,397496,-267904
2015-03,280047,13022,38389,9020,157465,62070,12686,37907,2034,1499,107.34,1,103.84,293069,317537,-24468
2015-04,195942,49908,36918,12906,128093,187229,29907,32103,2661,1655,142.51,1,120.76,245850,427156,-181306
2015-05,405497,26309,39847,10746,94137,105000,26814,29648,2023,2562,238.3,0,114.28,431806,306192,125614
2015-06,148881,46212,31643,12818,171022,230614,21355,23070,4842,1955,-12.3,0,112.7,195093,490522,-295429
2015-07,180638,35636,43020,5773,116309,169535,12381,27973,3071,1677,132.19,0,92.25,216274,374991,-158717
2015-08,270437,23623,29265,13875,189971,99004,7522,29685,4124,1072,152.16,1,131.28,294060,369322,-75262
2015-09,426596,42577,43635,5790,137636,108601,23741,23568,1010,3614,381.43,1,148.6,469173,342971,126202
2015-10,454284,23959,27330,8034,135548,98505,5616,38612,891,308,510.14,1,116.95,478243,313645,164598
2015-11,405634,21231,32037,9178,119768,146174,21318,22354,2651,783,193.26,0,149.29,426865,350829,76036
2015-12,298745,36777,23194,5766,104952,121896,23686,36574,3215,320,107.81,1,125.51,335522,316068,19454
2016-01,229953,21938,46433,7880,114870,229621,5012,15366,4447,1578,28.04,0,94.2,251891,419182,-167291
2016-02,476889,40943,34669,8859,190493,70950,24259,5706,3961,1064,103.67,0,132.35,517832,334936,182896
2016-03,101493,47111,21519,6567,120894,78259,5953,18895,1176,2150,182.86,1,126.95,148604,252087,-103483
2016-04,246025,12174,49219,10676,193950,115547,9093,10146,572,2545,440.13,1,85.03,258199,388631,-130432
2016-05,128866,37549,35602,6116,124765,247975,25957,5072,2776,3289,50.14,0,138.8,166415,445487,-279072
2016-06,404099,28173,46774,6795,118594,160583,18185,9301,2644,835,150.34,0,115.22,432272,360232,72040
2016-07,127678,11295,41003,5505,104066,203953,16062,33983,1995,3135,32.3,0,100.23,138973,404572,-265599
2016-08,130945,36073,31284,6094,89415,214807,9057,13730,4467,2157,6.18,1,141.01,167018,364387,-197369
2016-09,113783,31198,42801,12714,147600,182684,18851,22093,3677,3266,96.77,1,147.3,144981,426743,-281762
2016-10,155413,46195,47722,11961,137386,186076,16458,18649,3669,1283,34.66,1,85.59,201608,418252,-216644
2016-11,202992,22405,40035,7621,122472,131528,9677,8594,4975,1957,-33.77,0,117.0,225397,319927,-94530
2016-12,486246,14714,28035,10907,136470,224672,25728,32440,2084,363,169.51,1,124.7,500960,458252,42708
2017-01,388496,42570,33607,8876,100992,141012,21750,18135,3421,3362,155.73,0,110.95,431066,324372,106694
2017-02,282623,31462,49429,5328,113218,223167,26401,11385,2317,1156,140.08,0,135.51,314085,428928,-114843
2017-03,346186,32599,27934,7300,101552,195055,11128,38331,2835,2495,82.98,1,129.52,378785,381300,-2515
2017-04,412823,40661,23158,6875,185033,227029,25893,7998,3067,366,127.43,1,85.69,453484,475986,-22502
2017-05,385330,11117,26959,9315,154556,163176,6357,20355,2531,3706,167.27,0,93.54,396447,380718,15729
2017-06,110487,27707,34520,9724,148349,183752,17994,38998,3448,1995,33.3,0,94.3,138194,433337,-295143
2017-07,136045,14232,24726,10781,186845,65531,8972,10387,1733,546,63.16,0,147.64,150277,307242,-156965
2017-08,386759,38306,40332,14970,176950,148637,8408,10261,2595,3260,131.18,1,135.23,425065,399558,25507
2017-09,195273,45697,29343,9777,95102,82782,21525,23219,703,3456,274.65,1,95.88,240970,261748,-20778
2017-10,207056,13600,22296,8473,124682,195413,10516,19624,3593,1310,75.8,1,110.57,220656,381004,-160348
2017-11,203484,24092,28777,6524,128490,187236,16955,33606,2733,1340,40.34,0,117.92,227576,401588,-174012
2017-12,432788,43376,42978,14401,187469,188880,27646,19903,3791,750,158.64,1,87.71,476164,481277,-5113
2018-01,195127,44566,29158,13140,177978,200386,11687,14414,1888,3977,55.81,0,127.64,239693,446763,-207070
2018-02,448558,43624,48077,7515,191659,246429,26396,5293,817,788,663.39,0,130.38,492182,525369,-33187
2018-03,375187,27451,46320,10132,145619,231791,29123,18375,3502,481,3.53,1,80.88,402638,481360,-78722
2018-04,319008,42686,47722,6020,88164,70156,15471,25128,575,3398,537.93,1,136.99,361694,252661,109033
2018-05,356905,34552,40192,7977,120383,88433,7583,15455,2193,3492,177.77,0,121.64,391457,280023,111434
2018-06,359799,47938,21701,13440,176043,247453,18049,24634,3729,2279,88.52,0,110.64,407737,501320,-93583
2018-07,166919,26174,25503,9008,116090,240976,6380,21162,2332,1463,142.07,0,135.84,193093,419119,-226026
2018-08,456007,33859,32756,14706,157856,161676,12040,7001,2375,942,246.11,1,95.83,489866,386035,103831
2018-09,373292,25701,42245,7223,95140,60815,6766,29817,3574,2327,-7.55,1,90.47,398993,242006,156987
2018-10,282004,29343,34162,9104,198474,107461,23290,15593,2865,791,43.01,1,99.89,311347,388084,-76737
2018-11,212453,15793,47502,7343,167431,135801,22003,32975,4113,2854,45.03,0,123.41,228246,413055,-184809
2018-12,101572,29583,20153,9393,150976,115447,22282,18141,3670,1549,94.65,1,100.31,131155,336392,-205237
2019-01,197753,35400,46365,14657,120534,230911,19601,13554,3476,489,137.8,0,149.49,233153,445622,-212469
2019-02,228571,17336,41798,12814,120613,205776,18636,21449,504,3520,438.67,0,81.01,245907,421086,-175179
2019-03,250320,47555,37406,10651,88019,139472,5662,12721,2857,1081,112.01,1,139.12,297875,293931,3944
2019-04,132948,38845,27135,11150,90803,81527,9819,15042,2860,2458,80.2,1,149.94,171793,235476,-63683
2019-05,171118,29520,32480,14676,195974,51348,24870,31631,4848,2967,50.06,0,101.15,200638,350979,-150341
2019-06,448008,29240,31486,5286,116907,103287,18021,20227,2052,2259,253.14,0,132.72,477248,295214,182034
2019-07,358533,17890,28430,5744,99724,182853,27923,7577,3526,1200,92.05,0,146.62,376423,352251,24172
2019-08,181686,42344,22161,14759,191658,88746,20643,6150,3724,319,74.8,1,81.65,224030,344117,-120087
2019-09,372088,10973,44527,5121,157001,96440,29100,36176,4389,3756,32.78,1,112.71,383061,368365,14696
2019-10,496177,46644,33711,13487,170635,105780,8973,26515,4014,3173,122.08,1,128.78,542821,359101,183720
2019-11,265604,46712,29797,9174,86425,110336,11547,26282,3103,1240,102.82,0,114.6,312316,273561,38755
2019-12,209874,46696,31039,14017,122749,240126,19961,7405,2412,2977,83.55,1,101.23,256570,435297,-178727
2020-01,117946,22684,30664,13377,152249,192000,13352,38291,2279,2839,-8.78,0,98.7,140630,439933,-299303
2020-02,111508,37386,46490,11825,198389,67334,8130,22281,3628,881,-1.47,0,104.98,148894,354449,-205555
2020-03,101988,47502,30438,10406,165360,120144,17377,9127,2582,2895,20.33,1,135.72,149490,352852,-203362
2020-04,171196,25431,45122,9412,195341,243474,5098,23689,1899,1501,81.1,1,130.13,196627,522136,-325509
2020-05,438367,18161,31470,5407,117722,135869,27064,32974,4046,390,90.07,0,99.81,456528,350506,106022
2020-06,401080,19872,31065,10378,87641,51446,27614,13795,617,2798,592.92,0,131.72,420952,221939,199013
2020-07,426556,24639,39022,5059,175956,139915,26306,29936,4278,1960,13.8,0,98.04,451195,416194,35001
2020-08,481458,17572,47589,9955,177338,226383,22203,37346,3586,2185,218.18,1,116.42,499030,520814,-21784
2020-09,396651,26745,46560,14012,133864,220733,14753,21867,1898,2138,204.38,1,130.65,423396,451789,-28393
2020-10,189051,30296,24836,12377,85851,146500,5660,37859,2297,2909,107.0,1,141.01,219347,313083,-93736
2020-11,337869,12874,44544,6311,196203,144377,8323,24831,2283,2138,145.93,0,112.77,350743,424589,-73846
2020-12,332821,16227,29733,10633,143936,119606,8875,19936,2362,3037,150.69,1,84.47,349048,332719,16329
2021-01,256792,35130,44403,8345,103105,132862,7030,19390,4148,1562,50.1,0,149.53,291922,315135,-23213
2021-02,266586,14577,32149,12515,155283,111885,5568,8982,1247,312,227.37,0,145.45,281163,326382,-45219
2021-03,336837,39004,43272,5990,146138,111292,17338,37400,3981,3823,61.28,1,119.08,375841,361430,14411
2021-04,447997,21121,48670,5373,103058,121654,28553,25180,3791,964,30.43,1,120.11,469118,332488,136630
2021-05,152250,43454,24082,8418,161962,206897,11652,13683,2927,3996,53.66,0,128.77,195704,426694,-230990
2021-06,230480,15508,46890,14639,123775,174991,6246,15657,3178,2684,123.69,0,89.23,245988,382198,-136210
2021-07,414635,37816,34276,9617,105732,168943,9923,22215,1786,3675,286.38,0,126.25,452451,350706,101745
2021-08,459916,15535,45571,5891,148322,87860,18225,30916,790,2112,602.61,1,101.77,475451,336785,138666
2021-09,314001,42092,32495,10059,123222,206152,17986,16757,3129,3389,84.84,1,97.06,356093,406671,-50578
2021-10,263985,30540,47127,11865,114273,130177,13584,21919,1354,2894,152.83,1,83.77,294525,338945,-44420
2021-11,209780,35791,32404,10677,191066,182846,10660,31693,528,565,451.69,0,148.68,245571,459346,-213775
2021-12,178111,25176,24377,13510,136450,230102,16562,26875,1942,3483,91.31,1,141.03,203287,447876,-244589
2022-01,167252,14340,28017,10450,192313,190375,5536,21449,4452,2305,43.86,0,80.32,181592,448140,-266548
2022-02,416724,29684,27481,9648,148576,129984,13668,25095,4629,985,43.35,0,116.49,446408,354452,91956
2022-03,450083,33593,40197,6392,91283,116483,21344,27760,904,729,559.82,1,147.54,483676,303459,180217
2022-04,254117,32348,39020,14118,103278,203407,17286,14317,2352,2621,87.22,1,80.28,286465,391426,-104961
2022-05,344188,23737,41918,5414,157885,101976,23280,29838,707,2843,494.86,0,148.43,367925,360311,7614
2022-06,411539,10826,27114,13537,171214,204276,18396,37273,754,3452,647.1,0,135.61,422365,471810,-49445
2022-07,460214,14335,32999,7824,86702,135098,28511,9128,4241,446,62.44,0,147.9,474549,300262,174287
2022-08,366200,25626,44013,10349,117185,101545,6738,8201,2500,545,212.83,1,136.69,391826,288031,103795
2022-09,101299,28742,26144,12971,88877,189326,11169,15271,2135,3459,117.49,1,101.22,130041,343758,-213717
2022-10,164951,15027,49145,10768,150704,103535,6430,16723,4744,3074,-20.32,1,90.15,179978,337305,-157327
2022-11,145338,47845,49514,14176,106900,76960,17659,24957,3967,1071,32.54,0,105.06,193183,290166,-96983
2022-12,349754,39890,26269,5952,153899,114594,15707,14781,3753,1291,226.06,1,144.3,389644,331202,58442
2023-01,166090,29738,47422,7158,84336,93923,25923,38138,1778,2656,47.99,0,98.09,195828,296900,-101072
2023-02,439158,24423,21432,10230,109586,111507,13649,7185,3219,1543,206.37,0,114.35,463581,273589,189992
2023-03,374753,33373,40351,5744,115394,174604,20398,9372,1963,3927,173.85,1,148.8,408126,365863,42263
2023-04,251952,21084,31712,13245,153934,92155,14166,36800,2429,1246,44.77,1,117.83,273036,342012,-68976
2023-05,306579,23057,25040,12899,94233,124191,16667,9372,1795,805,181.27,0,104.14,329636,282402,47234
2023-06,358228,29871,34976,9221,130621,143082,22259,32223,2316,1225,236.99,0,122.77,388099,372382,15717
2023-07,368140,36897,29453,10694,85097,171997,8555,38119,2625,949,98.84,0,113.89,405037,343915,61122
2023-08,392136,29525,30378,9291,175823,244310,6040,9469,3757,720,126.37,1,116.26,421661,475311,-53650
2023-09,250248,33931,40719,6161,85378,221599,8309,9757,4898,3985,15.12,1,136.69,284179,371923,-87744
2023-10,416460,30755,31944,8317,150987,202746,23058,18468,1218,390,384.27,1,132.87,447215,435520,11695
2023-11,193480,20047,42739,10560,85062,176996,21194,21061,1535,3839,189.86,0,103.34,213527,357612,-144085
2023-12,186945,48599,35862,7864,135561,74577,29063,31630,609,2229,285.75,1,136.14,235544,314557,-79013
2024-01,316970,35231,47121,8204,83292,74447,18982,26558,3233,1706,141.34,0,121.36,352201,258604,93597
2024-02,424951,36559,44171,13309,164988,230526,12923,38175,3527,3814,43.09,0,81.72,461510,504092,-42582
2024-03,253019,22657,43986,5607,108222,147452,23653,21164,3346,3720,37.92,1,143.39,275676,350084,-74408
2024-04,278864,24439,34558,12598,149458,165958,18905,10935,1285,3905,166.23,1,121.29,303303,392412,-89109
2024-05,458630,44028,43558,10661,178755,176075,25083,12712,2046,716,191.6,0,93.0,502658,446844,55814
2024-06,165892,30442,37160,6934,192747,167938,5563,14450,1031,898,177.59,0,144.99,196334,424792,-228458
2024-07,143774,11653,36239,8638,193528,97960,6197,8500,3877,1071,41.28,0,140.44,155427,351062,-195635
2024-08,199718,15275,23031,13538,120177,195408,15400,26436,3055,1331,55.82,1,99.62,214993,393990,-178997
2024-09,223264,13854,45295,14459,92833,142870,13126,38067,681,1518,348.34,1,113.63,237118,346650,-109532
2024-10,448680,14274,36033,5629,81476,191554,23455,19488,4370,1108,81.42,1,101.05,462954,357635,105319
2024-11,131027,43596,43958,9423,90319,139616,22192,21220,3429,1779,45.5,0,106.02,174623,326728,-152105
2024-12,150767,24948,21507,12939,93247,119744,6832,31293,775,2992,128.74,1,92.14,175715,285562,-109847
2025-01,238058,23228,45529,14818,116772,247196,23330,7435,2581,1289,196.91,0,141.92,261286,455080,-193794
2025-02,120285,27859,23278,9723,191505,217132,14254,25718,1211,3313,93.01,0,134.81,148144,481610,-333466
2025-03,488854,27578,43661,6674,94327,77839,22028,21964,2867,3423,196.35,1,92.15,516432,266493,249939
2025-04,183796,16690,42413,9647,150226,214962,13916,5165,2581,3157,147.05,1,121.62,200486,436329,-235843
2025-05,442835,31349,37753,12215,138373,78129,25439,33158,4550,2167,106.72,0,98.92,474184,325067,149117
2025-06,456422,34637,42498,7447,198003,173431,7858,31148,1798,2835,250.3,0,115.17,491059,460385,30674
2025-07,125345,20333,33717,12798,134347,228845,25141,30175,3638,2337,-47.41,0,115.36,145678,465023,-319345
2025-08,148043,24986,43735,5171,138202,160563,8765,28052,3549,1478,56.54,1,91.52,173029,384488,-211459
2025-09,288655,21825,40978,9577,181515,106575,14566,17359,4819,498,56.0,1,84.41,310480,370570,-60090
2025-10,249782,24211,25684,13384,105864,237512,5008,7662,4999,2579,80.0,1,102.41,273993,395114,-121121
2025-11,357564,49231,27750,6906,198053,217716,17929,31838,4672,3079,60.86,0,114.38,406795,500192,-93397
2025-12,351918,47872,33318,13260,93883,175162,14207,14955,4845,2807,99.46,1,101.47,399790,344785,55005
2026-01,200170,41564,45245,5829,129574,238351,14029,22870,3392,2697,73.47,0,104.57,241734,455898,-214164
2026-02,459121,48408,30770,6165,173756,199068,16055,39341,1617,1288,238.14,0,80.02,507529,465155,42374
2026-03,396360,10151,39686,10554,146163,148337,10224,13216,4900,861,98.36,1,95.45,406511,368180,38331
2026-04,243507,13901,33114,6687,164182,175246,17563,35650,616,2890,357.69,1,80.05,257408,432442,-175034
2026-05,485242,49072,24795,11830,157432,216299,25219,13451,2861,3787,186.72,0,121.17,534314,449026,85288
2026-06,113126,40831,30783,7795,121862,71706,22773,33220,4814,2595,-5.0,0,111.1,153957,288139,-134182
2026-07,336576,31741,37189,9604,132545,74839,14558,33275,3900,2194,150.97,0,101.22,368317,302010,66307
2026-08,453236,40738,46100,8543,169488,130028,19262,25475,3743,2014,85.18,1,97.75,493974,398896,95078
2026-09,290766,18457,25046,13822,197188,228182,24491,11006,4875,3416,25.15,1,115.06,309223,499735,-190512
2026-10,314953,24451,25047,5629,139977,236439,20846,35814,4385,1304,132.95,1,91.14,339404,463752,-124348
2026-11,428274,47187,31873,9766,190759,211763,28640,33028,1496,3863,244.83,0,112.15,475461,505829,-30368
2026-12,443519,38724,48356,12934,167203,117961,21156,25203,4196,2828,86.85,1,110.33,482243,392813,89430
2027-01,234019,32487,37478,9461,149247,157765,10676,20294,2056,3020,85.41,0,145.39,266506,384921,-118415
2027-02,434387,21479,48281,6570,197800,150134,6326,23993,4471,2788,168.96,0,96.96,455866,433104,22762
2027-03,360157,13104,24585,10490,93837,133679,9586,5859,550,1224,694.63,1,96.49,373261,278036,95225
2027-04,209180,35132,39525,7747,94931,231068,12622,21753,4056,2039,57.3,1,125.71,244312,407646,-163334
2027-05,229337,17465,46470,14276,109898,155075,10228,34812,1645,1963,60.38,0,141.22,246802,370759,-123957
2027-06,385028,14951,39373,13367,167206,82578,15409,39951,2005,1642,147.59,0,127.9,399979,357884,42095
2027-07,283675,12262,33298,13452,183714,177553,26682,21363,2425,2416,119.89,0,142.28,295937,456062,-160125
2027-08,357370,35724,29488,14530,134118,215789,14604,35468,806,525,476.64,1,148.71,393094,443997,-50903
2027-09,384775,43502,23380,11660,167400,70456,5816,33309,1906,2343,242.78,1,84.58,428277,312021,116256
2027-10,256233,15439,30900,8069,176669,193161,8949,8541,678,3828,382.86,1,80.64,271672,426289,-154617
2027-11,391766,16800,28719,13958,92596,155028,10572,5156,3525,3652,91.99,0,117.62,408566,306029,102537
2027-12,319740,32750,20446,5965,195463,195847,17016,11878,867,1886,359.28,1,117.38,352490,446615,-94125
2028-01,322127,16292,42488,8612,170320,200295,20725,34775,3880,394,41.94,0,117.44,338419,477215,-138796
2028-02,477763,49511,41840,7421,100772,53710,9582,39559,2626,2504,256.21,0,132.95,527274,252884,274390
2028-03,422326,49217,20480,5674,173366,84639,10858,24989,1910,3987,243.84,1,81.39,471543,320006,151537
2028-04,127196,29560,21926,9027,168118,126960,17153,30652,3882,692,-48.12,1,139.17,156756,373836,-217080
2028-05,105263,23481,24173,13390,196591,142219,20180,14536,3394,3978,45.42,0,132.44,128744,411089,-282345
2028-06,181940,49546,31663,8367,134494,218863,11226,9481,758,2999,297.87,0,134.72,231486,414094,-182608
2028-07,373829,48585,31552,6417,94459,186823,20949,19393,4776,1257,83.05,0,122.95,422414,359593,62821
2028-08,290986,39251,46655,10750,115467,246450,23697,14951,4742,1418,79.94,1,142.72,330237,457970,-127733
2028-09,352866,41220,40252,11294,148948,188703,29532,39485,4362,818,102.77,1,134.02,394086,458214,-64128
2028-10,345194,45290,36830,11190,193345,71223,27544,9680,908,1945,376.18,1,124.62,390484,349812,40672
2028-11,283452,29989,31185,13483,190914,202239,14887,27693,1251,1988,230.64,0,142.61,313441,480401,-166960
2028-12,429015,39418,20859,6291,146194,77646,26494,7344,2469,1160,148.43,1,95.76,468433,284828,183605
2029-01,175769,32978,45421,8883,104546,198880,29266,19961,2630,687,22.17,0,128.83,208747,406957,-198210
2029-02,464912,29514,48036,5007,170837,94404,8399,37497,951,2797,501.9,0,130.53,494426,364180,130246
2029-03,339729,44841,24402,11735,189675,216525,10158,31713,3730,1704,148.71,1,149.98,384570,484208,-99638
2029-04,194447,17160,27418,8852,140597,149225,18001,29282,1557,2576,10.15,1,100.66,211607,373375,-161768
2029-05,123132,24198,25042,12102,188319,52439,17659,8337,2001,2889,108.36,0,94.35,147330,303898,-156568
2029-06,455989,46861,27952,9581,153439,121058,25333,11991,1550,1616,278.14,0,103.12,502850,349354,153496
2029-07,116772,28693,45172,13892,183111,101239,29734,9954,1823,3141,30.47,0,138.57,145465,383102,-237637
2029-08,488974,38233,26062,12339,138846,223533,15185,26391,1784,3883,221.99,1,132.44,527207,442356,84851
2029-09,350782,47393,39954,5641,101179,247969,19934,12203,775,1773,466.75,1,138.24,398175,426880,-28705
2029-10,277877,23800,39183,13464,157008,186329,13567,31505,1724,1467,36.98,1,89.09,301677,441056,-139379
2029-11,292788,19600,32342,5723,161600,66560,16284,7949,3810,2843,39.56,0,130.88,312388,290458,21930
2029-12,411062,17687,46198,5169,195895,102758,13788,36573,4873,2502,147.6,1,136.14,428749,400381,28368
2030-01,386148,49516,20496,12073,168312,124011,6855,32507,2913,3256,173.77,0,123.86,435664,364254,71410
2030-02,437110,48910,21385,10641,190071,63914,27983,7375,2245,1402,244.77,0,126.92,486020,321369,164651
2030-03,130825,33853,28626,13751,123918,120641,22433,21837,969,1512,157.12,1,138.29,164678,331206,-166528
2030-04,166437,29134,27984,12237,158895,238697,16276,8499,4005,3849,21.82,1,135.48,195571,462588,-267017
2030-05,105273,36000,45015,8418,160208,68368,12131,9814,3095,2845,81.01,0,122.25,141273,303954,-162681
2030-06,144237,30116,21156,10114,176715,110180,25099,14689,1722,559,35.34,0,144.61,174353,357953,-183600
2030-07,150363,25933,49301,10535,97224,128007,16287,34165,4256,446,-3.64,0,89.79,176296,335519,-159223
2030-08,289355,41911,33296,14661,99020,130146,26785,15250,4876,1670,69.7,1,124.67,331266,319158,12108
2030-09,277254,15115,28301,6845,177844,175576,6518,16590,4721,2053,28.79,1,137.7,292369,411674,-119305
2030-10,156150,46565,34282,12846,134279,93803,18793,32720,1995,3941,98.0,1,97.4,202715,326723,-124008
2030-11,372844,39947,42285,9987,99654,125324,5215,38818,4526,385,45.88,0,122.27,412791,321283,91508
2030-12,408429,11024,21949,10502,112397,92920,18382,11393,640,1348,590.75,1,97.77,419453,267543,151910
2031-01,297115,29349,26724,13068,194533,192699,21055,37512,1261,2528,228.68,0,128.85,326464,485591,-159127
2031-02,138562,11160,22095,14222,97615,210962,6084,32392,3776,641,-53.03,0,83.48,149722,383370,-233648
2031-03,353735,21323,28543,5679,148154,232010,22719,17894,4234,3425,14.47,1,131.39,375058,454999,-79941
2031-04,406549,32295,27319,6816,123172,222370,19634,13222,2630,2790,151.82,1,107.23,438844,412533,26311
2031-05,488820,18799,22864,6139,113920,107912,27384,33512,3827,1692,133.26,0,133.52,507619,311731,195888
2031-06,314089,40223,35645,9674,126839,194602,22408,17116,4037,3712,124.19,0,127.87,354312,406284,-51972
2031-07,200529,14579,32044,14241,96247,206251,27402,13649,4058,1926,-23.53,0,115.61,215108,389834,-174726
2031-08,426383,43618,48556,13197,176127,205708,9694,36353,826,1542,518.46,1,139.17,470001,489635,-19634
2031-09,139308,39364,44923,8251,133937,221629,12852,22550,1297,2151,46.3,1,83.16,178672,444142,-265470
2031-10,228974,38587,22344,10991,104716,199845,19411,9335,2333,451,65.79,1,83.33,267561,366642,-99081
2031-11,202509,27163,34893,14581,98066,109250,26856,16000,3320,3089,81.57,0,92.32,229672,299646,-69974
2031-12,407808,23055,41980,6992,112059,103998,9747,33856,1089,2457,386.38,1,113.36,430863,308632,122231
2032-01,263980,11252,31172,14016,130449,143603,17926,12477,3463,920,50.97,0,97.29,275232,349643,-74411
2032-02,365076,12855,46498,8386,188443,79336,8798,34799,1858,1511,101.27,0,93.26,377931,366260,11671
2032-03,273703,49158,20737,13767,184148,238111,19954,8122,3369,2127,59.27,1,121.22,322861,484839,-161978
2032-04,131994,31718,29116,14455,150444,202692,13133,33160,3237,1463,44.14,1,87.5,163712,443000,-279288
2032-05,328603,32938,29160,8397,111690,219011,7788,39627,3183,3373,216.78,0,104.67,361541,415673,-54132
2032-06,196829,27807,26468,9165,197704,142916,21420,17505,3116,887,21.8,0,80.49,224636,415178,-190542
2032-07,479309,32045,20502,11710,104591,122184,14550,9786,4959,2351,118.62,0,138.35,511354,283323,228031
2032-08,234106,30999,28664,10538,139324,241451,5964,17119,824,3929,274.42,1,101.33,265105,443060,-177955
2032-09,465628,35915,33594,8181,166308,105949,27504,37736,3129,3150,58.29,1,129.04,501543,379272,122271
2032-10,165103,40263,33078,7073,180110,118687,7665,8353,1768,3317,87.16,1,133.31,205366,354966,-149600
2032-11,490279,16156,20195,13389,119214,202433,6330,20878,3392,3778,125.19,0,91.24,506435,382439,123996
2032-12,222464,29529,36740,6945,176675,67098,24052,9455,3442,3148,65.34,1,84.27,251993,320965,-68972
2033-01,114822,26390,25733,9557,110740,161855,22687,34196,1617,2962,55.1,0,132.73,141212,364768,-223556
2033-02,323206,41412,21351,14391,163469,186692,25064,15812,4932,1743,85.28,0,116.82,364618,426779,-62161
2033-03,341507,36400,31042,6121,103149,218283,11888,10574,4210,3904,146.25,1,133.52,377907,381057,-3150
2033-04,320314,42932,32104,5337,123177,152581,24324,38511,2612,3426,74.97,1,102.2,363246,376034,-12788
2033-05,216364,45987,39766,14164,85516,140090,26515,39692,3705,377,59.77,0,115.51,262351,345743,-83392
2033-06,426198,26119,27258,8458,187882,66515,17284,30559,2702,2086,184.97,0,124.86,452317,337956,114361
2033-07,385683,26294,46992,12260,174088,208985,9749,15352,1136,385,289.02,0,96.99,411977,467426,-55449
2033-08,267813,21495,39895,10573,149605,242564,12520,13949,2772,1767,28.66,1,139.1,289308,469106,-179798
2033-09,454177,30843,45738,11701,152559,55006,11508,6560,4827,3552,38.61,1,143.72,485020,283072,201948
2033-10,242350,26668,48731,5550,98471,149069,15178,20789,782,2383,190.5,1,113.79,269018,337788,-68770
2033-11,299212,37689,46774,6961,146255,104335,18616,31008,1654,2102,214.51,0,109.34,336901,353949,-17048
2033-12,248793,42203,45582,9041,113102,121681,23544,15515,4020,2702,102.41,1,82.84,290996,328465,-37469
2034-01,249481,35933,26722,11989,174364,149114,11879,29711,4139,2154,135.65,0,129.87,285414,403779,-118365
2034-02,300544,40261,40864,8399,149946,208642,14069,18596,3055,2819,127.22,0,113.03,340805,440516,-99711
2034-03,381761,13850,35961,13293,135310,56869,16955,21271,2806,3401,63.89,1,98.26,395611,279659,115952
2034-04,446252,12189,28107,14380,125215,173120,18028,34849,2283,1313,171.14,1,85.8,458441,393699,64742
2034-05,415205,42445,41900,11852,108117,57973,11317,6836,1574,2668,223.64,0,112.67,457650,237995,219655
2034-06,370644,37882,30650,6859,177374,53397,14153,6784,3199,3533,119.88,0,98.04,408526,289217,119309
2034-07,152847,34877,28015,7062,186746,222356,17590,11684,3897,2884,16.9,0,96.19,187724,473453,-285729
2034-08,256794,18626,36901,7029,90289,50294,5133,22041,2322,3887,70.03,1,101.41,275420,211687,63733
2034-09,111507,35684,46955,5245,127058,188604,15410,30427,1570,1550,18.51,1,89.21,147191,413699,-266508
2034-10,393457,43408,49983,10418,89150,141401,16904,12951,692,1976,511.65,1,100.95,436865,320807,116058
2034-11,426301,31965,24292,10402,126396,94245,21717,32726,2303,2957,196.84,0,120.67,458266,309778,148488
2034-12,299213,39691,25086,14831,167401,150608,25049,32845,856,2095,416.06,1,94.68,338904,415820,-76916
2035-01,248895,17972,49665,13725,107794,54645,11614,18748,3287,3791,24.4,0,127.28,266867,256191,10676
2035-02,225731,28685,43997,9556,118762,178973,23491,32740,1129,2018,238.02,0,87.41,254416,407519,-153103
2035-03,266728,48590,24378,14414,111416,215158,8299,23069,1990,640,145.22,1,81.86,315318,396734,-81416
2035-04,315647,38795,34982,7593,197467,134301,24520,39674,4638,3355,128.86,1,135.84,354442,438537,-84095
2035-05,266908,49477,35820,6845,116425,183041,19586,28725,2889,3588,100.45,0,130.33,316385,390442,-74057
2035-06,160639,25157,48009,5073,189972,171807,17610,23544,4847,3096,-35.1,0,105.86,185796,456015,-270219
2035-07,353166,16110,30351,10749,182869,166858,26679,10865,2388,3531,202.96,0,96.76,369276,428371,-59095
2035-08,141533,37002,25888,7041,183879,239837,22106,16978,2366,2080,57.9,1,130.56,178535,495729,-317194
2035-09,368777,11982,28358,6611,196123,54856,21982,19550,1138,2292,315.21,1,125.52,380759,327480,53279
2035-10,149816,25962,27829,11177,93475,123628,27177,25526,4181,3794,68.98,1,139.52,175778,308812,-133034
2035-11,225436,19185,32898,13979,117532,78223,7003,26131,1547,1896,157.31,0,135.75,244621,275766,-31145
2035-12,242254,36642,32602,6472,98516,241436,15663,15108,3269,3572,118.12,1,94.9,278896,409797,-130901
2036-01,184163,49419,22383,9032,183403,219147,24429,29933,1032,1043,153.72,0,134.21,233582,488327,-254745
2036-02,168970,24475,28873,7554,186955,168209,18619,33185,4983,1335,70.59,0,107.29,193445,443395,-249950
2036-03,461280,49151,20019,11512,100344,189834,11864,33798,953,2864,442.83,1,134.94,510431,367371,143060
2036-04,447135,20248,27740,13822,85367,80622,18114,39792,2044,1565,292.3,1,82.84,467383,265457,201926
2036-05,132234,46159,35095,12805,109518,196534,23921,31997,1082,3666,77.42,0,103.47,178393,409870,-231477
2036-06,225315,47443,43839,7730,182226,242971,16070,39420,1022,3449,277.98,0,81.72,272758,532256,-259498
2036-07,391189,11020,46456,7676,96048,86141,29674,13854,4429,1993,1.06,0,123.32,402209,279849,122360
2036-08,119245,37467,20329,6823,197925,98749,23345,10188,3110,1469,-17.43,1,113.76,156712,357359,-200647
2036-09,382282,29209,47699,7235,180757,231873,8430,35916,1680,1297,269.98,1,122.91,411491,511910,-100419
2036-10,100634,17386,42239,6953,127139,174917,5045,39441,4720,1046,50.98,1,137.07,118020,395734,-277714
2036-11,120070,15897,38278,10640,194175,82743,17121,19816,4639,779,24.24,0,92.27,135967,362773,-226806
2036-12,325186,41046,45273,12889,87787,226017,13251,32517,3681,987,81.59,1,127.46,366232,417734,-51502
2037-01,222630,46015,20383,10174,108330,233296,28803,5621,3596,2260,67.96,0,147.38,268645,406607,-137962
2037-02,223662,21559,36251,14683,164673,140454,29954,12413,4912,2094,123.77,0,135.12,245221,398428,-153207
2037-03,378682,25993,21529,8634,152707,62733,7794,29432,655,1832,543.62,1,84.34,404675,282829,121846
2037-04,301330,11869,49369,11006,113441,63132,18288,12459,1652,1752,68.57,1,112.18,313199,267695,45504
2037-05,186096,30184,42988,13773,174933,232319,27100,19712,1728,2426,34.68,0,80.02,216280,510825,-294545
2037-06,114402,14390,26145,10773,157683,239974,26424,33768,641,1996,197.6,0,88.24,128792,494767,-365975
2037-07,497782,27791,24893,8584,199074,203667,26869,22173,4001,3072,121.15,0,125.34,525573,485260,40313
2037-08,378397,45606,27791,6783,96141,103449,19230,28093,2098,2760,167.88,1,94.82,424003,281487,142516
2037-09,377097,34909,34205,9532,86704,120736,12819,7351,2526,2232,107.08,1,84.97,412006,271347,140659
2037-10,472547,17513,36683,9340,156239,191670,26079,28645,3829,521,96.65,1,121.23,490060,448656,41404
2037-11,279047,12551,49309,9909,182381,153214,5032,22968,3802,745,107.52,0,128.88,291598,422813,-131215
2037-12,211744,22339,25996,14820,81093,184102,16909,34984,1702,3101,86.32,1,104.34,234083,357904,-123821
2038-01,396153,43071,43787,9193,150145,79540,27298,13554,3164,3078,99.79,0,112.8,439224,323517,115707
2038-02,452945,27911,41357,5612,119007,94113,23868,5803,1949,3006,251.52,0,125.55,480856,289760,191096
2038-03,484915,45678,48927,9056,156943,71240,17747,31829,1290,3613,335.77,1,87.29,530593,335742,194851
2038-04,159037,49043,47956,11962,146982,246629,18790,27226,604,1304,179.95,1,98.71,208080,499545,-291465
2038-05,442557,45934,25604,11597,137628,50191,13513,33689,2696,1637,116.0,0,103.37,488491,272222,216269
2038-06,104735,45569,47915,10219,117154,69313,12797,19775,1670,3222,87.73,0,119.26,150304,277173,-126869
2038-07,487926,31804,24925,7586,145207,226576,24386,38476,2730,686,162.52,0,137.93,519730,467156,52574
2038-08,357849,32677,34404,6576,190984,152145,10504,25393,2665,3772,165.49,1,98.09,390526,420006,-29480
2038-09,208071,14880,39612,11187,147471,76135,29160,30204,1723,334,115.05,1,82.13,222951,333769,-110818
2038-10,438136,17298,28858,14280,163707,55107,23316,31173,2268,2442,32.95,1,91.52,455434,316441,138993
2038-11,279232,31138,32453,5542,114159,170469,6670,36534,1769,1675,187.21,0,101.55,310370,365827,-55457
2038-12,478371,17533,26530,8176,173367,156097,20028,21782,2417,720,138.66,1,110.86,495904,405980,89924
2039-01,244912,30508,37399,7950,114121,186968,8151,39083,3060,3686,1.5,0,127.75,275420,393672,-118252
2039-02,243182,14543,21958,5777,118385,142298,27181,13264,2744,2384,99.17,0,121.01,257725,328863,-71138
2039-03,228232,18022,45459,7828,137945,114152,28190,26254,1780,2631,102.36,1,91.15,246254,359828,-113574
2039-04,138691,41357,48137,12311,190703,69756,16512,24517,757,2202,223.62,1,130.94,180048,361936,-181888
2039-05,101657,20871,45259,14419,117904,206786,10621,25536,863,2102,43.66,0,138.83,122528,420525,-297997
2039-06,380814,38224,22949,12840,162630,240218,23151,13378,3364,3111,94.09,0,129.35,419038,475166,-56128
2039-07,210861,29044,30015,5502,159849,152706,11905,29763,4946,1228,6.65,0,103.53,239905,389740,-149835
2039-08,158036,37495,31975,9420,97679,76980,14442,18919,4342,3343,119.71,1,93.55,195531,249415,-53884
2039-09,117908,10691,31035,7414,80880,222376,20314,33961,1745,2986,-6.23,1,93.98,128599,395980,-267381
2039-10,388189,40732,34216,6538,88322,248758,5931,10404,2669,492,117.46,1,116.66,428921,394169,34752
2039-11,349523,20226,45752,7697,100012,248828,18374,27213,4711,2525,135.07,0,123.4,369749,447876,-78127
2039-12,266247,21623,33548,6447,138337,193042,16786,28980,3846,2858,43.45,1,93.32,287870,417140,-129270
2040-01,135368,49783,37703,6313,162186,241679,16647,19736,1657,3726,101.03,0,83.14,185151,484264,-299113
2040-02,496713,48163,39402,11918,168995,150506,23228,19338,3040,3483,103.28,0,138.96,544876,413387,131489
2040-03,135055,16555,22544,10968,139601,200269,14849,39344,828,2938,134.92,1,144.5,151610,427575,-275965
2040-04,144489,10143,48615,13338,80056,78976,6638,7812,2445,3917,27.61,1,88.38,154632,235435,-80803
2040-05,241845,28589,22981,14814,122398,138801,12615,18807,4157,1008,116.04,0,98.8,270434,330416,-59982
2040-06,461227,41223,26391,10287,87171,72295,11421,35796,1210,2047,450.04,0,112.43,502450,243361,259089
2040-07,493193,41286,35481,10433,179250,191618,15313,11902,4013,1656,165.33,0,91.55,534479,443997,90482
2040-08,359892,11274,34011,13007,102746,65757,25599,28431,4174,3065,84.76,1,121.36,371166,269551,101615
2040-09,122563,45004,29144,8773,160456,209799,14656,23454,4377,2644,33.73,1,140.87,167567,446282,-278715
2040-10,360280,43525,22651,11279,190295,213479,6143,32505,2815,619,122.51,1,97.07,403805,476352,-72547
2040-11,169835,47527,47031,8755,186025,206651,11175,11655,2537,2475,1.63,0,146.29,217362,471292,-253930
2040-12,446865,11441,29352,10502,118560,97358,11638,17762,599,415,689.01,1,128.45,458306,285172,173134
2041-01,129858,18461,40466,5632,112753,177057,14721,17150,841,1154,166.82,0,111.56,148319,367779,-219460
2041-02,492814,43405,27434,12467,135010,160813,25310,24157,2040,3489,197.67,0,136.44,536219,385191,151028
2041-03,172950,41175,41536,7321,154322,80557,10002,25151,2310,3418,99.74,1,114.47,214125,318889,-104764
2041-04,100004,37272,46104,14224,147901,133254,22009,35491,868,790,65.59,1,125.47,137276,398983,-261707
2041-05,388384,32032,36493,12032,118599,173671,20366,6605,1396,1278,282.88,0,102.48,420416,367766,52650
2041-06,487921,15609,34531,14332,130033,195868,9769,23102,4148,1276,86.29,0,96.65,503530,407635,95895
2041-07,264377,22060,36604,7065,184034,183519,5450,8065,3611,1706,44.7,0,144.57,286437,424737,-138300
2041-08,482843,38084,35700,5219,157478,62776,6848,34571,4666,523,120.43,1,102.3,520927,302592,218335
2041-09,294940,24261,37385,12130,139746,138403,8407,28827,2005,3253,275.66,1,92.91,319201,364898,-45697
2041-10,360857,30199,23399,12001,183831,83706,6285,17268,2479,716,82.03,1,130.25,391056,326490,64566
2041-11,281930,41262,39804,8567,95382,191326,11204,21927,2528,3883,110.65,0,111.58,323192,368210,-45018
2041-12,482581,28467,26802,5173,84029,65977,20633,21361,2492,835,274.67,1,114.37,511048,223975,287073
2042-01,367650,30158,22785,7998,161865,209600,9754,15804,683,2722,580.13,0,86.93,397808,427806,-29998
2042-02,239628,31778,23507,12597,179080,111411,17013,19452,549,3365,468.02,0,124.12,271406,363060,-91654
2042-03,383871,20316,28594,11592,184474,78203,8142,6516,646,1679,549.62,1,139.8,404187,317521,86666
2042-04,413198,30961,40127,9655,131842,78849,17725,7319,676,1872,604.16,1,82.48,444159,285517,158642
2042-05,471111,11918,22637,9074,171326,228522,27393,7980,4930,1919,11.39,0,81.05,483029,466932,16097
2042-06,267616,49013,40602,14932,90446,94330,26206,21489,2621,2857,204.48,0,102.31,316629,288005,28624
2042-07,410529,32427,36287,11979,97832,134730,21828,12895,4200,3141,34.68,0,139.66,442956,315551,127405
2042-08,470185,12875,43524,5119,92116,200067,12455,16506,4260,3021,104.09,1,129.51,483060,369787,113273
2042-09,432172,46297,29390,7096,162129,238181,6226,8373,813,3697,530.56,1,133.43,478469,451395,27074
2042-10,398600,10789,34966,8675,164966,146043,15258,39219,1694,3508,179.54,1,102.15,409389,409127,262
2042-11,111508,42679,27513,7611,181034,51901,15604,36301,1869,1637,29.13,0,93.41,154187,319964,-165777
2042-12,425094,15422,29461,6664,135835,137582,18358,38321,1038,1286,392.83,1,101.11,440516,366221,74295
2043-01,135612,23742,30173,7205,113636,62757,12027,21628,4101,844,49.73,0,117.61,159354,247426,-88072
2043-02,393621,19855,22211,12699,153763,114421,26017,7871,3053,1145,205.3,0,132.61,413476,336982,76494
2043-03,244069,21824,35596,9189,124824,65814,5448,25617,1302,3587,182.04,1,83.66,265893,266488,-595
2043-04,172336,34936,21001,6885,157591,93459,19173,26837,2769,1138,97.13,1,111.66,207272,324946,-117674
2043-05,477392,33448,44941,12439,136341,84136,20706,30971,1365,392,458.08,0,123.67,510840,329534,181306
2043-06,168946,27648,34014,5183,123596,98614,29942,29638,2119,1079,112.38,0,116.58,196594,320987,-124393
2043-07,112015,15324,40992,14812,95533,190857,23212,11346,4704,908,1.47,0,90.75,127339,376752,-249413
2043-08,466275,27006,43034,5518,89802,188518,22382,15770,4748,3703,148.82,1,108.14,493281,365024,128257
2043-09,269052,47177,36908,14929,166928,63609,16554,33242,2356,920,145.55,1,134.07,316229,332170,-15941
2043-10,485411,48486,32884,10119,89001,79896,16680,26130,1107,1222,413.54,1,98.04,533897,254710,279187
2043-11,129041,40057,22123,12883,194485,187107,24673,23525,1926,3930,107.6,0,129.19,169098,464796,-295698
2043-12,249404,14316,20111,8289,82585,204692,17916,37978,3387,984,36.25,1,113.09,263720,371571,-107851
2044-01,291497,29074,21111,6636,169637,121172,18613,8417,2774,1440,73.97,0,134.99,320571,345586,-25015
2044-02,498631,47728,31457,5861,81014,203566,9563,27412,2638,2141,212.51,0,104.98,546359,358873,187486
2044-03,181708,28682,29079,13613,84773,170139,27478,12708,4440,3463,5.46,1,117.24,210390,337790,-127400
2044-04,148325,40945,49360,14147,140938,206139,11016,24927,2407,2537,130.46,1,91.0,189270,446527,-257257
2044-05,435360,22907,45965,5943,121725,206432,5260,35758,4157,2061,187.7,0,99.26,458267,421083,37184
2044-06,249250,48626,41364,9034,84032,126379,20097,6538,3534,3945,102.62,0,98.44,297876,287444,10432
2044-07,305874,26456,37450,6595,138393,117250,20207,33132,1208,2799,218.41,0,145.26,332330,353027,-20697
2044-08,109713,28794,48979,9081,137540,109344,13502,30733,4433,3071,43.81,1,113.32,138507,349179,-210672
2044-09,242722,20403,28658,11119,95845,133498,27057,14366,4277,627,130.86,1,101.27,263125,310543,-47418
2044-10,128778,13216,37307,10938,161384,89915,25133,7080,3000,2303,125.23,1,87.09,141994,331757,-189763
2044-11,394768,41688,22362,6657,188228,123160,16055,24835,2553,1251,134.62,0,116.04,436456,381297,55159
2044-12,292603,27842,36263,9631,178486,201218,27561,27308,2758,3915,45.15,1,82.08,320445,480467,-160022
2045-01,213443,26239,30624,10198,145618,130821,29469,5194,3635,1719,69.34,0,115.13,239682,351924,-112242
2045-02,260990,25808,48123,10658,130970,190594,6621,38554,1832,2139,212.46,0,128.85,286798,425520,-138722
2045-03,193838,27949,38568,11875,162661,133707,26761,7403,1585,709,138.66,1,133.44,221787,380975,-159188
2045-04,337075,48000,25034,12488,180432,79371,7993,34799,4959,890,96.65,1,142.9,385075,340117,44958
2045-05,445245,42700,39604,6333,101919,170417,12054,26806,4572,1197,11.18,0,103.79,487945,357133,130812
2045-06,269519,22051,30960,9718,140130,78920,14638,32108,2531,3104,112.61,0,126.93,291570,306474,-14904
2045-07,162553,37356,29456,10465,83406,107737,26822,25413,1258,726,42.4,0,115.26,199909,283299,-83390
2045-08,387575,22502,25014,11938,81705,125200,28148,25965,1527,448,189.18,1,98.92,410077,297970,112107
2045-09,225018,30291,33913,13473,157801,113060,15032,12309,1793,2248,171.16,1,127.2,255309,345588,-90279
2045-10,190105,45119,39048,5039,162428,166342,18823,22685,1481,3692,149.26,1,124.34,235224,414365,-179141
2045-11,480757,22985,21992,11042,147091,86048,6226,8907,531,1060,987.33,0,88.08,503742,281306,222436
2045-12,123190,28841,23557,7062,195742,249680,24947,37918,1734,1058,136.28,1,130.45,152031,538906,-386875
2046-01,361159,40970,33941,7788,186699,104994,14273,34098,4652,1945,66.7,0,87.22,402129,381793,20336
2046-02,114885,20955,26779,8581,144318,227525,16768,34929,2318,3450,8.73,0,121.13,135840,458900,-323060
2046-03,367593,24129,25559,12675,149760,158751,12613,18935,4615,1501,85.57,1,86.74,391722,378293,13429
2046-04,439645,33557,26384,10462,143107,93814,9126,5483,3011,1954,180.96,1,89.24,473202,288376,184826
2046-05,351777,29010,38890,12827,119682,151400,26947,19713,3472,2224,119.22,0,141.2,380787,369459,11328
2046-06,149189,35314,33891,14427,120902,79980,17540,5576,2164,3027,19.18,0,148.95,184503,272316,-87813
2046-07,441522,33232,21075,14528,169178,118830,5022,19580,3503,830,175.75,0,108.24,474754,348213,126541
2046-08,435409,12886,25810,8998,128296,104827,19978,24165,3400,3183,89.62,1,130.31,448295,312074,136221
2046-09,302583,24848,26591,9546,165781,53814,15936,21233,4229,2562,80.65,1,124.0,327431,292901,34530
2046-10,299102,16229,44542,6521,131940,85473,12731,7559,2889,2814,183.96,1,133.04,315331,288766,26565
2046-11,228337,13594,34234,5102,129886,56042,25985,8199,4458,2144,35.88,0,90.12,241931,259448,-17517
2046-12,104426,32239,40528,13665,199266,211381,15605,31814,1378,2543,51.1,1,139.93,136665,512259,-375594
2047-01,251478,41132,48730,6794,186783,227251,13237,29975,3047,3417,105.65,0,133.25,292610,512770,-220160
2047-02,372057,18230,24254,12301,91822,92806,7536,34920,4014,736,103.36,0,94.74,390287,263639,126648
2047-03,302342,46900,28553,10185,146796,230927,26450,21646,2159,1542,126.0,1,108.49,349242,464557,-115315
2047-04,300522,30438,39055,7919,110130,50215,12302,8239,1678,2607,212.86,1,82.48,330960,227860,103100
2047-05,187321,47066,22020,10633,124748,172543,10310,29295,2164,568,86.73,0,107.4,234387,369549,-135162
2047-06,284058,46548,36100,14865,143117,119779,5941,30197,2430,1750,121.38,0,107.6,330606,349999,-19393
2047-07,470400,18196,21960,12592,165887,133175,14021,28710,4789,1246,155.15,0,80.36,488596,376345,112251
2047-08,226786,42771,30127,8245,95633,243295,11004,16244,4213,463,88.15,1,123.82,269557,404548,-134991
2047-09,243003,46245,26143,7590,91404,212317,25492,14704,1818,3633,172.21,1,105.08,289248,377650,-88402
2047-10,489794,30783,30479,11239,128374,98313,15232,31932,2959,3882,178.15,1,134.88,520577,315569,205008
2047-11,133043,47124,41211,14270,194325,106385,10688,20293,1145,3067,248.72,0,100.05,180167,387172,-207005
2047-12,125881,49150,37539,8669,155513,125618,8827,29513,4064,1511,11.35,1,94.52,175031,365679,-190648
2048-01,238120,33769,46107,13346,167297,164469,21828,15861,2327,2036,160.05,0,136.66,271889,428908,-157019
2048-02,316844,30605,49055,5115,120274,95461,13743,19212,2738,3257,119.0,0,84.39,347449,302860,44589
2048-03,483588,25640,35036,7630,142044,217060,13122,22840,1633,2396,257.56,1,114.77,509228,437732,71496
2048-04,188948,32891,45868,5247,116666,249644,5001,27827,1912,2915,41.09,1,92.13,221839,450253,-228414
2048-05,471785,30315,36524,9145,164760,237615,26014,25284,4350,1381,162.34,0,122.17,502100,499342,2758
2048-06,449543,12791,30207,5963,199208,238276,27688,29393,2627,2166,164.57,0,91.45,462334,530735,-68401
2048-07,320463,42308,44600,9140,192533,68573,6394,19533,1356,962,280.15,0,117.41,362771,340773,21998
2048-08,189996,33937,34489,7354,158585,223489,15419,13059,4136,1745,33.16,1,81.18,223933,452395,-228462
2048-09,185541,41681,39865,8603,143401,142769,9135,14802,1041,3523,167.99,1,97.24,227222,358575,-131353
2048-10,339844,11516,40644,11185,106037,113657,17721,32384,1774,2560,207.58,1,93.96,351360,321628,29732
2048-11,432539,33102,36901,6169,174187,228563,8011,14904,1438,2428,338.78,0,144.52,465641,468735,-3094
2048-12,177169,40605,39876,14346,144756,84023,26351,13904,1588,3464,143.17,1,83.37,217774,323256,-105482
2049-01,222831,13736,41464,9470,192124,127796,19899,32752,1672,690,77.83,0,142.68,236567,423505,-186938
2049-02,371255,22821,25333,14615,147026,140091,26834,11406,3760,590,105.24,0,123.83,394076,365305,28771
2049-03,380671,31083,21272,6842,110762,140830,12822,27660,3155,581,111.93,1,108.5,411754,320188,91566
2049-04,486449,18562,30554,6926,158785,131592,23017,6572,4570,1227,118.37,1,110.81,505011,357446,147565
2049-05,433347,37437,49380,13176,110421,204885,11645,26010,4171,3751,184.64,0,110.26,470784,415517,55267
2049-06,329287,37921,44003,13727,179524,63286,27368,17416,1763,2937,277.38,0,89.08,367208,345324,21884
2049-07,197450,33004,41208,8348,168153,169267,11358,8777,2297,3173,71.84,0,139.47,230454,407111,-176657
2049-08,224108,15629,22350,13752,110587,230028,6228,38519,2021,2579,127.45,1,124.64,239737,421464,-181727
2049-09,309163,44920,49507,11938,113507,182941,14469,18753,4673,2773,89.46,1,83.75,354083,391115,-37032
2049-10,395628,48957,45240,12352,154373,191627,20572,31324,2335,3999,137.46,1,97.58,444585,455488,-10903
2049-11,452125,21492,47087,12512,170457,83041,27274,36685,1455,2751,377.43,0,98.26,473617,377056,96561
2049-12,495419,39646,37275,14273,145697,58608,14888,31827,4455,420,129.19,1,94.44,535065,302568,232497
2050-01,308426,43846,44582,9296,173821,220806,14240,23319,4265,2773,118.75,0,128.86,352272,486064,-133792
2050-02,405361,14486,37822,6090,165813,147093,19837,30060,4025,2959,107.78,0,124.53,419847,406715,13132
2050-03,180321,32005,45886,12806,115427,113990,10155,21913,4513,3568,56.48,1,83.68,212326,320177,-107851
2050-04,429023,44023,39775,6801,165271,141944,26726,28990,1579,1275,310.71,1,133.77,473046,409507,63539
2050-05,166360,29210,28753,5200,193374,231207,11576,5122,2802,2787,129.35,0,97.99,195570,475232,-279662
2050-06,385136,43404,48654,14475,127196,80622,15889,17404,3672,3321,73.75,0,102.81,428540,304240,124300
2050-07,121907,14546,41340,9805,105194,90085,9918,10075,842,901,207.41,0,145.94,136453,266417,-129964
2050-08,363509,49095,27700,10214,110861,112407,11494,18829,4529,789,150.05,1,109.91,412604,291505,121099
2050-09,375426,30854,30165,6070,199271,212270,29510,19295,3761,926,49.01,1,139.68,406280,496581,-90301
2050-10,379807,45515,32539,13552,160435,247018,18405,34145,3195,518,75.22,1,119.37,425322,506094,-80772
2050-11,354076,29520,39571,9595,178794,218099,15878,7318,4880,429,30.22,0,115.69,383596,469255,-85659
2050-12,321357,41729,48224,5188,199826,92605,29358,15798,3839,651,114.06,1,149.36,363086,390999,-27913
2051-01,436149,29345,46870,11339,145045,164486,19456,35421,3204,1228,187.46,0,142.85,465494,422617,42877
2051-02,158935,43463,44025,11942,106662,224959,5197,39804,3030,3657,-13.22,0,104.84,202398,432589,-230191
2051-03,372483,17071,38188,5088,179113,63838,13907,24427,4319,3512,49.37,1,146.64,389554,324561,64993
2051-04,462383,49110,26249,7586,194871,178131,19296,24454,917,898,650.33,1,142.14,511493,450587,60906
2051-05,164255,14695,42332,6735,84180,173136,20670,35823,1521,3832,88.98,0,115.44,178950,362876,-183926
2051-06,373899,42745,23638,8034,99455,136431,25696,27684,1648,2232,264.4,0,106.01,416644,320938,95706
2051-07,436905,31026,47634,9623,181023,167661,17824,27636,4578,666,64.76,0,139.53,467931,451401,16530
2051-08,226422,49041,24393,11576,89214,150653,10367,17214,1394,3708,111.77,1,106.49,275463,303417,-27954
2051-09,476815,12388,29294,6712,190024,117593,17838,20664,2414,3062,169.82,1,143.82,489203,382125,107078
2051-10,116112,20904,30542,9862,185082,202847,25199,8528,1283,761,104.56,1,147.81,137016,462060,-325044
2051-11,489657,22994,46769,9449,123777,101733,12741,38384,4448,527,123.05,0,131.33,512651,332853,179798
2051-12,413823,22267,43788,12055,177893,238104,12610,38596,2860,3667,148.69,1,118.83,436090,523046,-86956
2052-01,137127,10675,31315,13224,135395,144078,16426,38093,3084,701,42.91,0,138.86,147802,378531,-230729
2052-02,319077,31110,47771,6356,152784,67286,7884,39790,2503,1224,171.68,0,102.95,350187,321871,28316
2052-03,258303,16801,38348,11569,166923,66370,5239,32432,2007,2340,172.1,1,109.75,275104,320881,-45777
2052-04,352357,26539,42421,5545,85874,133942,26074,8218,4178,360,56.46,1,104.79,378896,302074,76822
2052-05,359446,16269,27282,12707,169146,76392,29506,23583,4382,3469,121.27,0,115.66,375715,338616,37099
2052-06,356181,11417,25609,8321,192100,95374,11324,22299,4826,1166,47.42,0,90.28,367598,355027,12571
2052-07,347811,45686,47010,8834,137808,214843,5722,6512,3717,2474,65.18,0,130.7,393497,420729,-27232
2052-08,332199,22581,25305,14957,89101,160625,13021,35925,1230,696,166.9,1,108.03,354780,338934,15846
2052-09,463752,10859,47958,10666,117340,127347,29764,27690,2045,2392,276.42,1,82.46,474611,360765,113846
2052-10,371413,19566,23905,14201,80486,109373,14065,28536,4534,2439,106.42,1,93.12,390979,270566,120413
2052-11,136594,30050,34734,14039,177864,237221,8423,26786,3992,825,21.57,0,138.13,166644,499067,-332423
2052-12,142864,20895,46171,11257,122043,140708,6427,30631,4279,2138,126.86,1,90.04,163759,357237,-193478
2053-01,292299,42392,29915,14108,188961,216463,14036,34602,4346,1897,-1.51,0,89.99,334691,498085,-163394
2053-02,433569,32748,22165,14202,132211,220090,19266,8801,4041,1408,12.71,0,129.98,466317,416735,49582
2053-03,122556,28674,43848,12550,198064,153541,16869,13269,2230,1220,115.04,1,84.55,151230,438141,-286911
2053-04,239835,28888,21219,13094,109318,168689,10033,8800,2213,502,120.9,1,137.24,268723,331153,-62430
2053-05,380311,15832,41459,14701,137606,200629,11697,15212,1311,608,286.51,0,110.04,396143,421304,-25161
2053-06,319319,43859,23472,12641,185584,182035,18328,37650,2128,2264,178.96,0,137.93,363178,459710,-96532
2053-07,428607,38564,33081,5314,181771,165508,6778,34354,2345,3323,149.82,0,119.84,467171,426806,40365
2053-08,241483,14164,22827,5075,190877,192255,18733,33864,3856,2074,5.16,1,112.47,255647,463631,-207984
2053-09,136335,31489,39015,10833,170185,52045,29904,29705,2247,2314,134.12,1,126.69,167824,331687,-163863
2053-10,232184,37666,31072,11269,195958,234640,12798,22296,4825,499,16.79,1,129.0,269850,508033,-238183
2053-11,285001,28035,26585,13897,182964,160119,5894,17904,516,2009,608.14,0,98.94,313036,407363,-94327
2053-12,388658,41539,33434,10229,142614,161088,24266,7981,4551,1168,106.39,1,131.76,430197,379612,50585
2054-01,484153,32747,47247,14583,103208,75246,24638,39769,1725,2333,286.74,0,131.76,516900,304691,212209
2054-02,102207,15131,48945,14964,109584,179750,22947,30524,2079,2848,36.48,0,124.0,117338,406714,-289376
2054-03,455395,37389,38584,9930,192291,63990,29384,34948,1214,784,388.23,1,131.01,492784,369127,123657
2054-04,462307,20489,21470,9270,114737,196380,11357,36266,2901,2159,73.62,1,136.01,482796,389480,93316
2054-05,295146,34685,24302,9467,183017,183281,9834,33038,4006,3221,219.22,0,81.2,329831,442939,-113108
2054-06,240628,31500,35895,6017,116504,134577,21862,33077,609,315,362.2,0,88.33,272128,347932,-75804
2054-07,356012,17244,26227,8904,168994,246211,14496,14374,3370,1386,105.18,0,91.04,373256,479206,-105950
2054-08,437372,13613,40660,7188,85389,187647,10256,12444,4229,1153,97.12,1,126.23,450985,343584,107401
2054-09,360429,44095,28617,7035,186702,95192,7836,9726,4283,1098,101.5,1,120.07,404524,335108,69416
2054-10,312651,19950,48111,13487,171028,57166,24607,6698,2406,2151,130.61,1,115.22,332601,321097,11504
2054-11,403295,22457,46574,7155,164704,179637,9946,21771,1617,1564,273.78,0,111.41,425752,429787,-4035
2054-12,104209,45866,39012,6904,109955,154027,17756,22656,4651,2706,42.28,1,136.81,150075,350310,-200235
2055-01,111257,43513,28141,6200,183760,222999,10066,15144,3795,1044,82.24,0,94.57,154770,466310,-311540
2055-02,215620,41296,38645,7616,102682,175962,15406,20669,2789,3559,41.35,0,102.29,256916,360980,-104064
2055-03,333779,39153,33534,9721,105117,235061,16780,36588,2182,1582,152.93,1,129.91,372932,436801,-63869
2055-04,332696,45064,28494,8904,94221,222444,25631,6883,4456,2488,52.49,1,95.03,377760,386577,-8817
2055-05,363979,39474,44963,5329,190536,227698,18594,33368,3727,3604,160.03,0,119.27,403453,520488,-117035
2055-06,140624,38410,47948,8717,170393,183901,28199,34737,751,2972,105.04,0,90.32,179034,473895,-294861
2055-07,427949,44358,24983,6378,146583,193574,23285,32954,941,589,419.48,0,102.65,472307,427757,44550
2055-08,382743,11695,44582,14842,80527,65972,29448,38093,1933,1398,91.7,1,94.38,394438,273464,120974
2055-09,168383,42467,46398,14868,187984,244936,17960,22011,3795,859,5.25,1,82.34,210850,534157,-323307
2055-10,148374,48043,37118,14885,125954,67723,22239,31657,784,903,197.06,1,147.48,196417,299576,-103159
2055-11,273225,46690,29108,9231,137536,96150,23964,37301,3511,3198,28.73,0,112.86,319915,333290,-13375
2055-12,163056,13598,29904,6974,120340,113111,17087,11235,1946,2297,169.21,1,123.29,176654,298651,-121997
2056-01,223661,26268,36575,14261,188719,128088,8793,37004,4208,1487,66.16,0,80.42,249929,413440,-163511
2056-02,209229,40076,43274,7770,115722,136722,17044,22823,2126,1726,77.91,0,118.89,249305,343355,-94050
2056-03,164905,37826,38285,5131,195309,217680,22233,19983,4036,1242,59.88,1,84.68,202731,498621,-295890
2056-04,448692,16518,23137,13865,188583,152799,23709,34668,2345,1251,167.6,1,108.23,465210,436761,28449
2056-05,451277,30611,27580,5100,135122,247077,9569,19627,1633,380,308.36,0,143.52,481888,444075,37813
2056-06,243029,17676,26810,12448,161645,243460,8505,34181,2140,2856,144.26,0,119.53,260705,487049,-226344
2056-07,187415,46795,28970,11973,146448,143312,12659,21284,3448,3054,121.63,0,140.61,234210,364646,-130436
2056-08,376393,21569,40932,7462,99494,99171,5081,22156,4313,2233,112.31,1,118.93,397962,274296,123666
2056-09,382010,38532,43883,8456,87986,199997,18215,37718,3708,2034,18.75,1,129.46,420542,396255,24287
2056-10,161157,19331,45287,6434,192063,181333,17142,30895,4964,3433,39.37,1,114.49,180488,473154,-292666
2056-11,458339,27679,30175,11896,119534,122719,20155,26883,4800,1503,153.33,0,143.33,486018,331362,154656
2056-12,257653,49862,49622,7377,168656,51810,22761,28790,3220,1143,1.63,1,115.03,307515,329016,-21501
2057-01,274489,19554,25482,9502,161977,92246,7941,33010,2296,2171,58.45,0,124.23,294043,330158,-36115
2057-02,105495,42768,24779,7269,110751,240101,12600,19084,3375,1961,77.16,0,122.63,148263,414584,-266321
2057-03,324548,18910,47148,12371,82667,70009,23025,17358,2979,3831,166.94,1,149.62,343458,252578,90880
2057-04,448546,43708,26930,12083,140800,119594,21623,34042,4269,1584,153.97,1,132.06,492254,355072,137182
2057-05,206655,26000,23467,12975,164845,58687,23936,28807,4385,356,86.77,0,112.76,232655,312717,-80062
2057-06,327900,45884,38394,7899,152849,162181,5762,6418,4812,1234,38.64,0,94.24,373784,373503,281
2057-07,415532,12184,23452,9946,93567,222507,10237,32290,2890,2466,145.53,0,139.93,427716,391999,35717
2057-08,151307,41473,22725,11404,117356,202963,9965,35701,2201,2283,144.34,1,105.08,192780,400114,-207334
2057-09,395227,14545,32034,12551,193651,135777,29983,35128,1147,3021,352.61,1,86.25,409772,439124,-29352
2057-10,127303,18324,26843,9705,130293,236920,9185,28059,3173,2413,72.48,1,106.86,145627,441005,-295378
2057-11,414156,37454,48194,10244,185153,114133,8764,35594,1765,3914,233.89,0,127.81,451610,402082,49528
2057-12,223582,10810,41191,12623,199778,227590,11875,39306,1480,2766,132.3,1,95.34,234392,532363,-297971
2058-01,345022,41198,44212,5231,120977,201652,26739,24080,3088,2647,112.36,0,103.48,386220,422891,-36671
2058-02,465385,44155,49273,14305,89645,81642,17175,26206,4855,2122,12.66,0,98.81,509540,278246,231294
2058-03,419924,46034,22964,14895,179216,224774,7254,32877,1870,746,175.88,1,149.27,465958,481980,-16022
2058-04,432223,43481,47753,8576,192751,245293,17440,10724,3784,1853,97.53,1,97.38,475704,522537,-46833
2058-05,122008,27260,39103,8611,177769,89870,16967,9606,3282,1376,77.99,0,106.36,149268,341926,-192658
2058-06,353408,40997,20159,7183,113882,162358,29923,32298,515,358,675.72,0,96.98,394405,365803,28602
2058-07,253365,44740,21962,5030,106898,62500,8967,31312,1174,3410,186.7,0,124.27,298105,236669,61436
2058-08,162963,34819,40059,6938,191354,144853,24034,34115,895,3395,205.47,1,145.95,197782,441353,-243571
2058-09,238917,49732,21635,10594,99774,200522,13363,8924,3233,3801,10.11,1,107.99,288649,354812,-66163
2058-10,337326,27419,37203,12336,127374,248672,18738,24850,3146,883,68.15,1,141.7,364745,469173,-104428
2058-11,409237,13606,29101,10486,187832,164770,7584,19830,580,3253,707.4,0,121.37,422843,419603,3240
2058-12,452580,40874,31976,10932,140511,109233,17095,24189,2159,2446,193.64,1,91.41,493454,333936,159518
2059-01,483740,10985,25688,11220,114664,177735,16633,15050,3213,2112,166.71,0,141.33,494725,360990,133735
2059-02,479786,43261,20015,10236,190006,148110,7430,15170,4128,1914,99.38,0,135.21,523047,390967,132080
2059-03,295336,45883,21837,8799,161745,77511,6159,22183,1150,1253,242.41,1,93.76,341219,298234,42985
2059-04,482983,14996,35674,10208,94107,129033,10389,18557,2627,2789,74.76,1,106.57,497979,297968,200011
2059-05,444668,14125,29691,7084,112395,81374,5547,17792,1131,1740,387.4,0,149.02,458793,253883,204910
2059-06,380554,34893,38903,7117,181263,248490,11656,25976,3735,1883,101.24,0,103.93,415447,513405,-97958
2059-07,251030,17364,40161,12381,148841,200884,15660,35703,4528,1611,22.2,0,148.04,268394,453630,-185236
2059-08,225267,19426,43327,13605,164822,183323,10973,23002,858,717,264.1,1,100.93,244693,439052,-194359
2059-09,103090,26606,31843,10721,131971,140238,26461,11047,4000,846,12.43,1,104.57,129696,352281,-222585
2059-10,157869,14033,39028,6584,171475,247967,27421,27633,713,603,241.15,1,96.33,171902,520108,-348206
2059-11,119945,22929,25366,9110,124636,125100,27893,10313,1058,694,141.13,0,132.12,142874,322418,-179544
2059-12,113991,32433,21543,7762,91226,50466,21150,31829,1319,2642,131.62,1,112.74,146424,223976,-77552
2060-01,312980,41876,24086,10648,159418,109682,13254,12830,4441,1361,96.7,0,134.97,354856,329918,24938
2060-02,236330,26338,33603,14866,109526,219938,20092,38505,628,315,394.37,0,96.92,262668,436530,-173862
2060-03,334529,42606,20388,14389,185989,182400,29648,36481,1001,2996,317.92,1,105.21,377135,469295,-92160
2060-04,248876,43095,20855,12243,167447,234109,20762,31649,2496,2351,156.76,1,114.37,291971,487065,-195094
2060-05,190398,31983,45075,12479,199396,98943,26936,10338,1279,3507,248.46,0,94.03,222381,393167,-170786
2060-06,464913,44920,26241,13302,189048,115546,12100,19366,2176,3325,218.74,0,83.52,509833,375603,134230
2060-07,160962,27014,40368,14032,168477,215277,13216,36992,4337,1585,13.93,0,114.73,187976,488362,-300386
2060-08,355879,31127,44135,5272,183570,102811,13419,29392,4348,732,36.45,1,101.2,387006,378599,8407
2060-09,258919,32554,20501,7969,85122,138497,19250,17673,3522,2456,23.97,1,120.88,291473,289012,2461
2060-10,236364,27081,36103,11592,158053,199939,16800,10348,2233,3189,122.41,1,116.84,263445,432835,-169390
2060-11,438188,43076,26936,10619,87761,139904,11170,36269,2222,3019,194.41,0,122.78,481264,312659,168605
2060-12,351112,46475,30553,13368,192848,227513,25111,7971,766,3856,404.5,1,123.32,397587,497364,-99777
2061-01,183920,21441,40182,12808,108783,144789,7760,11992,2127,2803,83.67,0,87.68,205361,326314,-120953
2061-02,476398,26754,29920,9405,197526,186964,27764,15255,534,2064,966.8,0,96.89,503152,466834,36318
2061-03,441366,31892,30843,12131,183462,76001,23092,35460,1162,2135,290.3,1,81.74,473258,360989,112269
2061-04,207493,16180,26046,9090,94334,78845,29064,21235,3493,1219,69.37,1,115.11,223673,258614,-34941
2061-05,275837,42488,38209,7246,110958,139762,16326,12043,2996,2361,-10.55,0,94.92,318325,324544,-6219
2061-06,215804,46441,32008,9024,138415,126357,15668,15783,1936,3694,89.89,0,94.22,262245,337255,-75010
2061-07,279251,35773,45304,13379,180073,137023,29079,24164,3523,3752,63.08,0,82.34,315024,429022,-113998
2061-08,344597,10845,47224,14274,89093,187479,12993,35961,3663,509,47.25,1,82.74,355442,387024,-31582
2061-09,339954,26101,26256,8653,182876,157221,21673,5723,4242,424,56.5,1,127.11,366055,402402,-36347
2061-10,183613,44762,26773,12141,152080,159886,26512,22238,3565,2402,62.98,1,112.1,228375,399630,-171255
2061-11,122356,25040,28279,13749,120573,152441,29720,22329,1018,1961,122.77,0,118.19,147396,367091,-219695
2061-12,369008,20171,40548,11156,141667,129343,27016,28556,733,473,482.15,1,143.87,389179,378286,10893
2062-01,309568,41719,34990,13453,150519,181066,20733,11625,2835,1368,52.73,0,130.47,351287,412386,-61099
2062-02,345491,37730,30524,10560,110576,179184,5116,16171,3582,3197,122.63,0,117.82,383221,352131,31090
2062-03,173229,15229,45236,14036,118472,163214,13831,25784,3185,3136,-32.12,1,103.62,188458,380573,-192115
2062-04,455985,39922,42684,8710,113633,147017,20901,15644,2190,3474,138.38,1,145.11,495907,348589,147318
2062-05,455307,30217,45985,7488,97295,169234,25383,6551,3068,3246,172.2,0,141.53,485524,351936,133588
2062-06,272028,30631,45236,8826,173494,220697,7916,17133,2781,383,140.39,0,140.49,302659,473302,-170643
2062-07,212732,15082,44155,5082,138454,113140,12341,32220,2953,3223,174.36,0,111.15,227814,345392,-117578
2062-08,445659,26478,29306,6243,169139,160796,8271,20230,4520,1769,139.16,1,148.91,472137,393985,78152
2062-09,193408,15918,42786,8928,92683,178990,22575,21598,4008,2546,-18.16,1,115.39,209326,367560,-158234
2062-10,176597,26793,23720,6146,142555,91225,16046,11515,819,374,228.16,1,104.14,203390,291207,-87817
2062-11,478957,40446,26223,8776,168402,211042,22195,25093,2535,816,141.6,0,83.02,519403,461731,57672
2062-12,177765,48043,35364,5045,135525,72516,17646,6025,3393,2271,77.3,1,135.11,225808,272121,-46313
2063-01,307938,21713,23479,10930,134846,202510,11219,17401,754,3095,420.28,0,82.03,329651,400385,-70734
2063-02,116432,28430,20310,5959,145834,205977,19315,31490,2031,2311,50.43,0,111.66,144862,428885,-284023
2063-03,240529,23102,36610,7474,117643,167250,24855,19230,4775,1301,39.38,1,124.07,263631,373062,-109431
2063-04,202364,37408,49853,8525,170583,112671,8496,24138,2207,1474,97.67,1,111.45,239772,374266,-134494
2063-05,138895,12891,31780,14959,109411,232997,29435,36679,4327,2289,45.36,0,112.17,151786,455261,-303475
2063-06,481321,42544,31558,13209,98172,139862,26779,35212,2721,3333,183.51,0,131.71,523865,344792,179073
2063-07,360824,24006,31839,11257,92346,133466,16748,33851,1917,3500,109.42,0,105.68,384830,319507,65323
2063-08,334189,41795,38886,11338,142649,138020,19400,39653,2974,1364,49.81,1,122.54,375984,389946,-13962
2063-09,462403,24222,44296,9044,129001,241596,9680,19206,3570,588,76.13,1,145.02,486625,452823,33802
2063-10,258059,25026,49704,13190,173635,62558,17960,25713,4747,1601,-16.15,1,107.85,283085,342760,-59675
2063-11,245298,18804,34957,12082,102723,241208,8492,37167,861,2446,276.41,0,108.02,264102,436629,-172527
2063-12,107842,43142,26677,10860,118205,158614,17899,17824,4960,2918,26.84,1,133.65,150984,350079,-199095
2064-01,420104,23839,46350,11217,107497,50774,22970,22365,3239,2838,193.54,0,139.77,443943,261173,182770
2064-02,369400,38799,35980,11813,168425,98239,10932,38204,4581,849,17.69,0,101.12,408199,363593,44606
2064-03,159123,29471,42015,14129,153118,54206,12559,38544,1452,1407,127.78,1,133.68,188594,314571,-125977
2064-04,103710,45268,30345,6332,145481,160089,28995,24259,2539,3859,37.61,1,137.38,148978,395501,-246523
2064-05,258194,39540,25443,14953,142022,226926,16182,21975,3222,2389,110.46,0,83.39,297734,447501,-149767
2064-06,237036,30078,49862,7323,114150,95213,7644,38594,2089,1057,77.4,0,120.79,267114,312786,-45672
2064-07,119118,10421,25809,6574,87940,217239,10063,21854,1618,304,37.79,0,117.58,129539,369479,-239940
2064-08,202387,43117,22709,7000,141754,145636,6218,39679,2459,2500,67.22,1,99.75,245504,362996,-117492
2064-09,187188,37621,35635,7379,87655,102540,17111,21635,3141,1589,85.49,1,145.07,224809,271955,-47146
2064-10,134954,30366,22451,6254,128293,245842,13247,26912,1089,1542,138.42,1,90.73,165320,442999,-277679
2064-11,493039,28476,38992,14884,146833,187996,16447,24174,4115,1838,50.14,0,135.36,521515,429326,92189
2064-12,220249,35070,36790,10923,131499,97427,14075,8679,3375,3111,70.82,1,114.4,255319,299393,-44074
2065-01,274792,15693,49834,13931,185965,123837,28682,31227,1382,1058,218.03,0,115.2,290485,433476,-142991
2065-02,327939,43033,23139,9942,112624,156220,21609,21492,3359,3603,60.07,0,124.52,370972,345026,25946
2065-03,204168,28673,23215,8056,182707,231837,5071,15612,1643,2095,153.8,1,121.1,232841,466498,-233657
2065-04,468811,20856,25250,12235,90318,223025,26459,21512,2379,1898,167.85,1,114.71,489667,398799,90868
2065-05,449226,11963,20401,8433,138137,61115,6410,31314,3867,3432,184.54,0,82.76,461189,265810,195379
2065-06,117650,22871,25290,14779,88573,87901,18872,8214,861,3824,175.65,0,125.73,140521,243629,-103108
2065-07,434457,10831,29785,12718,92332,212612,20671,10681,3212,1281,51.74,0,147.41,445288,378799,66489
2065-08,319612,29087,45347,7239,198429,178416,24656,23956,1270,2832,240.45,1,122.12,348699,478043,-129344
2065-09,147140,39432,47294,13253,179581,199065,28885,30881,4066,3265,-44.26,1,140.83,186572,498959,-312387
2065-10,153393,24030,21987,5464,97530,194785,29828,31572,3230,567,-29.94,1,101.74,177423,381166,-203743
2065-11,146497,30913,34377,13914,104561,54554,20460,27665,4672,2388,123.05,0,128.07,177410,255531,-78121
2065-12,101383,36206,48971,7686,126165,122913,5894,13446,3353,2816,-37.13,1,123.83,137589,325075,-187486
2066-01,117801,19132,41951,8558,151730,89307,7552,27979,3166,2002,86.62,0,81.22,136933,327077,-190144
2066-02,327401,48723,46792,7293,196438,208167,7348,30827,2114,1907,174.59,0,112.71,376124,496865,-120741
2066-03,219218,35920,48011,12094,161501,146475,27396,19560,2172,2030,104.11,1,110.24,255138,415037,-159899
2066-04,422741,32502,22833,10864,86797,123240,20885,16001,840,873,565.93,1,118.51,455243,280620,174623
2066-05,371616,19136,33275,7436,97296,180792,22119,33663,3616,3537,82.32,0,103.15,390752,374581,16171
2066-06,416091,25300,31846,12299,170554,118121,22975,23017,3500,1225,82.04,0,132.5,441391,378812,62579
2066-07,299015,42582,36444,10677,176479,233163,16926,8819,2286,495,189.29,0,135.51,341597,482508,-140911
2066-08,239665,40646,24116,8813,95046,197322,22333,31696,933,964,287.8,1,94.97,280311,379326,-99015
2066-09,446909,36716,34900,10663,108393,167733,15773,10212,2592,3083,96.81,1,125.78,483625,347674,135951
2066-10,159951,24229,45327,13061,100778,202652,12374,23951,763,729,156.23,1,134.94,184180,398143,-213963
2066-11,218573,43877,21960,13372,113942,120307,11448,22326,1305,2615,146.95,0,140.2,262450,303355,-40905
2066-12,336347,31935,40859,6377,173778,200081,8473,37045,3262,2707,48.04,1,128.27,368282,466613,-98331
2067-01,172987,10394,36259,13458,111928,215315,23525,35866,2337,2248,61.38,0,110.32,183381,436351,-252970
2067-02,248306,49340,47607,14308,196887,112358,7327,15428,4078,3886,66.14,0,80.44,297646,393915,-96269
2067-03,295627,27388,44449,9167,189593,203866,15053,16670,812,613,404.8,1,108.68,323015,478798,-155783
2067-04,106564,12182,28624,14795,101506,180318,11077,38369,3795,3977,-18.17,1,86.75,118746,374689,-255943
2067-05,373596,29456,27695,7391,115247,72576,14065,19071,4879,3857,41.62,0,94.59,403052,256045,147007
2067-06,367479,43594,31199,12075,138343,72430,22931,20569,4417,1021,119.52,0,108.51,411073,297547,113526
2067-07,470748,26684,35652,10215,194250,139403,18354,14628,621,1929,748.08,0,101.53,497432,412502,84930
2067-08,209640,49695,38335,7204,93707,195181,22805,17107,612,2021,255.32,1,83.47,259335,374339,-115004
2067-09,158777,34791,34582,5999,188048,143781,12526,28343,2243,3529,69.7,1,135.18,193568,413279,-219711
2067-10,455914,26579,36500,7088,163573,209049,15652,29874,2714,3630,160.98,1,87.28,482493,461736,20757
2067-11,362647,22619,25151,10918,108030,189127,19563,9460,4827,669,4.39,0,147.16,385266,362249,23017
2067-12,177393,22141,29977,6744,158529,75636,23070,34800,1217,1334,72.05,1,93.54,199534,328756,-129222
2068-01,480063,22072,45310,13711,184203,117132,7013,12761,692,2178,617.11,0,142.29,502135,380130,122005
2068-02,397768,48345,44540,8614,139645,169547,22063,21079,4832,3797,7.8,0,93.74,446113,405488,40625
2068-03,121341,37026,22522,11726,93829,154434,20760,16794,934,3579,187.8,1,110.14,158367,320065,-161698
2068-04,274165,19411,39536,12735,128159,145192,18149,23888,715,391,361.61,1,118.53,293576,367659,-74083
2068-05,268697,24725,21282,14371,106118,229069,7573,17011,3730,2844,60.62,0,102.1,293422,395424,-102002
2068-06,357464,30151,20685,13221,186999,159730,22301,32109,1600,3232,254.27,0,86.76,387615,435045,-47430
2068-07,253397,27336,40271,8281,150651,86932,13854,37304,3100,3203,66.41,0,117.82,280733,337293,-56560
2068-08,461191,26136,40989,5712,91111,109987,17238,8506,1536,2842,245.13,1,114.66,487327,273543,213784
2068-09,491127,19541,23830,6402,130811,141108,9542,23626,3810,1610,106.85,1,126.58,510668,335319,175349
2068-10,221001,46385,27422,10085,168671,190666,25972,14793,3030,2091,71.91,1,134.82,267386,437609,-170223
2068-11,341829,44888,28840,12312,199284,173015,12549,28314,3131,3525,212.92,0,127.62,386717,454314,-67597
2068-12,336339,17661,36460,14743,155310,154580,16026,30611,4688,1814,125.37,1,133.98,354000,407730,-53730
2069-01,222914,40207,49723,11927,150800,60123,26798,29632,4999,709,55.13,0,81.19,263121,329003,-65882
2069-02,419930,27987,45544,7332,169391,216883,17526,6210,3490,3987,63.11,0,115.36,447917,462886,-14969
2069-03,106600,10535,29293,8438,101989,133392,20735,8457,2546,2332,-11.76,1,133.95,117135,302304,-185169
2069-04,204850,49085,21386,12753,113478,249696,26596,5983,1448,2110,168.42,1,121.97,253935,429892,-175957
2069-05,158134,34554,24566,6792,184753,123529,7846,32751,3719,2614,138.2,0,127.11,192688,380237,-187549
2069-06,304910,26728,46178,13003,135841,231741,16018,35974,2918,327,117.17,0,82.43,331638,478755,-147117
2069-07,360980,30592,48603,11888,144436,237742,21089,39607,2906,2689,131.53,0,130.62,391572,503365,-111793
2069-08,493471,38836,41955,8520,155941,205769,27285,37149,3203,2738,137.19,1,148.32,532307,476619,55688
2069-09,383880,15975,49950,9854,145416,120089,22233,16049,3337,3412,62.19,1,126.74,399855,363591,36264
2069-10,302838,18211,30185,13089,114969,237969,20027,17304,1480,2517,200.31,1,147.62,321049,433543,-112494
2069-11,170380,31049,38475,14912,150231,131926,11744,5335,935,375,174.02,0,116.88,201429,352623,-151194
2069-12,424878,47282,31242,9141,136636,193431,9175,7280,1153,673,295.31,1,92.98,472160,386905,85255
2070-01,218428,25430,32631,14909,135778,215150,23075,33662,1353,1810,249.13,0,126.6,243858,455205,-211347
2070-02,396855,38105,23025,9076,141706,216086,10924,35319,1049,1857,475.18,0,106.78,434960,436136,-1176
2070-03,244074,49082,34018,13812,143619,56087,10701,37320,3684,1459,68.7,1,81.71,293156,295557,-2401
2070-04,357049,23515,36127,11283,131396,237559,12563,5315,1024,881,284.19,1,90.04,380564,434243,-53679
2070-05,383644,10548,25884,13128,137191,169150,13563,11761,1456,944,307.88,0,87.08,394192,370677,23515
2070-06,448628,20725,47846,8816,159322,208570,29297,14117,1998,2473,126.54,0,110.07,469353,467968,1385
2070-07,246840,26693,23878,14431,118411,62569,29677,29761,1416,460,121.38,0,142.78,273533,278727,-5194
2070-08,273155,27932,48171,14731,132448,130605,8857,21896,517,3805,483.79,1,115.38,301087,356708,-55621
2070-09,125296,21788,26502,13044,131032,121667,27722,29910,4290,3912,64.71,1,145.53,147084,349877,-202793
2070-10,423600,20062,38936,11062,176737,192722,9319,18796,2967,1594,133.09,1,98.94,443662,447572,-3910
2070-11,403122,48462,23301,11852,194372,177427,24929,27468,1185,1667,311.43,0,108.54,451584,459349,-7765
2070-12,134339,23680,48588,8306,150116,118229,10075,8096,2135,3590,9.49,1,133.83,158019,343410,-185391
2071-01,166554,19623,42040,14872,145311,228313,21916,24526,4548,2668,102.95,0,135.27,186177,476978,-290801
2071-02,154549,26942,46502,14803,87678,120861,19547,15391,4670,1130,44.77,0,132.11,181491,304782,-123291
2071-03,128613,38865,35504,12471,126561,114525,12592,9202,1940,2361,13.26,1,85.21,167478,310855,-143377
2071-04,178797,23211,49107,14461,140856,64961,13319,7543,4151,3764,21.93,1,120.07,202008,290247,-88239
2071-05,375723,46006,49968,11181,160444,111136,5091,39038,1811,3417,187.48,0,102.52,421729,376858,44871
2071-06,185618,15592,39740,10615,154636,53110,18367,36455,4958,3849,-22.6,0,123.32,201210,312923,-111713
2071-07,377062,34380,43016,12624,152231,198101,25635,8986,3112,2841,180.24,0,113.38,411442,440593,-29151
2071-08,286574,45343,24756,14001,105768,181356,8167,28835,2839,3923,145.97,1,141.84,331917,362883,-30966
2071-09,300268,44557,46984,11513,87505,219850,22074,13606,918,1902,373.38,1,140.36,344825,401532,-56707
2071-10,408180,38415,48605,13418,145727,50692,26829,26389,4771,2307,144.63,1,80.7,446595,311660,134935
2071-11,165022,19578,44453,13814,173500,53050,15917,13420,2456,426,27.67,0,146.33,184600,314154,-129554
2071-12,328757,30628,42119,10392,125797,51236,25639,32833,2202,793,151.05,1,127.47,359385,288016,71369
2072-01,290701,19139,45015,11728,93110,207867,19833,7623,1922,2867,164.64,0,115.72,309840,385176,-75336
2072-02,346302,33921,49873,11772,150601,237808,12259,39838,2987,3694,70.15,0,81.98,380223,502151,-121928
2072-03,479593,35709,44708,6090,134626,104170,26200,9053,1965,2112,173.15,1,110.67,515302,324847,190455
2072-04,470429,22032,42611,10435,107666,235470,5633,38627,1807,2559,246.38,1,132.82,492461,440442,52019
2072-05,306914,26216,32778,9616,184321,210610,18460,16103,3260,1373,49.0,0,148.11,333130,471888,-138758
2072-06,353862,23372,20312,12462,81675,59558,15231,5426,4730,2344,32.79,0,133.35,377234,194664,182570
2072-07,249622,18295,23247,12224,144734,152398,17956,9900,2529,1138,79.95,0,122.57,267917,360459,-92542
2072-08,420092,27159,36639,9369,108689,132388,19241,5024,642,1158,687.7,1,108.48,447251,311350,135901
2072-09,153947,45348,33340,6869,190894,134596,29512,15143,4555,2533,22.78,1,103.98,199295,410354,-211059
2072-10,350298,15425,28718,6142,91989,216668,24819,30927,1380,2645,268.47,1,129.07,365723,399263,-33540
2072-11,277942,44237,22975,6977,104953,59223,22776,26419,3868,1561,147.86,0,105.43,322179,243323,78856
2072-12,228788,41080,35384,5933,174378,107172,18704,36657,4339,3966,5.34,1,145.74,269868,378228,-108360
2073-01,255963,31625,37412,8063,115071,116388,10651,32189,2236,2578,-49.99,0,93.67,287588,319774,-32186
2073-02,132074,21407,30656,6530,158935,53286,20384,26794,4192,546,-10.47,0,131.41,153481,296585,-143104
2073-03,456876,29228,22885,7078,176973,202868,14752,22009,3365,2108,42.42,1,112.51,486104,446565,39539
2073-04,181415,15604,22055,13117,176020,141549,21885,11687,4563,1136,84.37,1,141.89,197019,386313,-189294
2073-05,239591,29050,26940,11538,163868,132936,21418,33814,2640,2968,113.76,0,101.02,268641,390514,-121873
2073-06,498217,44991,23535,14011,140159,95185,8589,15270,1863,2532,218.3,0,137.92,543208,296749,246459
2073-07,226120,42042,48647,12742,159842,195287,27157,25233,3607,3846,-31.83,0,104.14,268162,468908,-200746
2073-08,126859,29939,20934,10647,175079,212060,26725,33069,4222,2656,44.83,1,121.34,156798,478514,-321716
2073-09,423587,18377,42352,6705,82578,141140,19522,24284,3002,541,144.61,1,104.23,441964,316581,125383
2073-10,114352,27088,35786,9834,88079,97994,27076,5759,3620,3763,52.5,1,99.3,141440,264528,-123088
2073-11,249190,20634,21249,5041,183725,132030,19218,18961,2730,793,132.32,0,106.31,269824,380224,-110400
2073-12,192400,27265,44196,8057,126481,153909,21704,15582,2069,2379,97.61,1,133.54,219665,369929,-150264
2074-01,195752,22236,35746,6412,87124,214297,17726,10122,4590,1694,5.88,0,149.44,217988,371427,-153439
2074-02,281426,43929,33892,12782,126677,138883,27350,25342,4263,2044,44.07,0,135.69,325355,364926,-39571
2074-03,488565,34794,31910,11905,106688,205676,19421,26674,4812,1523,187.53,1,123.98,523359,402274,121085
2074-04,466873,17401,20851,5894,141232,201973,24362,29667,564,2702,896.16,1,90.32,484274,423979,60295
2074-05,248607,49418,24823,5366,182357,217609,19489,15139,4654,3706,109.26,0,94.41,298025,464783,-166758
2074-06,358378,17633,49398,12197,143053,217771,28642,16335,3128,1996,53.04,0,90.22,376011,467396,-91385
2074-07,430579,22050,29529,13476,92962,132894,17074,19510,4497,1607,94.21,0,147.53,452629,305445,147184
2074-08,209041,26113,44628,12420,185243,53350,28571,28163,3384,2619,120.58,1,121.05,235154,352375,-117221
2074-09,306826,36851,49406,14067,105000,95510,20419,19559,3731,594,86.0,1,86.32,343677,303961,39716
2074-10,307514,34645,40581,9424,107081,83040,11922,17370,1631,2055,339.35,1,137.76,342159,269418,72741
2074-11,483552,42847,36825,12253,153314,127106,17384,29704,3095,3305,210.84,0,147.84,526399,376586,149813
2074-12,148975,34119,28884,7208,192376,62756,28560,24980,2423,1510,25.8,1,102.84,183094,344764,-161670
2075-01,388443,48379,49781,14624,111066,200687,6611,33876,689,3125,599.51,0,140.74,436822,416645,20177
2075-02,265346,17601,34303,10453,134190,127043,28739,17446,3983,2131,10.76,0,123.3,282947,352174,-69227
2075-03,489121,18046,26339,14987,199211,246508,15550,16428,4535,3369,112.54,1,83.74,507167,519023,-11856
2075-04,481524,30003,41822,13680,96055,138528,23684,19521,2579,1136,154.5,1,127.26,511527,333290,178237
2075-05,156253,12546,48099,6496,90934,196834,25564,9278,1613,1398,109.92,0,126.97,168799,377205,-208406
2075-06,419304,25534,30905,10246,176897,143987,13743,13191,863,1499,482.51,0,108.3,444838,388969,55869
2075-07,200321,34299,29877,7514,164963,150111,22297,37025,782,3315,266.48,0,89.24,234620,411787,-177167
2075-08,225159,27666,38258,10192,147391,184019,13701,39491,4870,1891,12.67,1,127.36,252825,433052,-180227
2075-09,403863,46241,45054,10948,188609,215897,6584,10738,2932,1069,296.72,1,132.53,450104,477830,-27726
2075-10,351610,49704,20981,10699,130993,217442,26612,15523,910,3388,356.57,1,109.17,401314,422250,-20936
2075-11,117358,49471,48798,11605,145116,210216,16684,28985,3868,2155,-3.46,0,115.41,166829,461404,-294575
2075-12,335074,40445,30663,12245,182687,134907,17831,34604,955,2260,385.06,1,122.03,375519,412937,-37418
2076-01,208338,15041,42905,6890,107789,82338,8858,17823,4613,1405,86.43,0,123.38,223379,266603,-43224
2076-02,381983,15579,29064,5462,87519,150505,13624,17754,4774,3159,12.25,0,96.08,397562,303928,93634
2076-03,231771,42931,48765,10715,102118,242511,15482,21656,4590,562,58.32,1,125.19,274702,441247,-166545
2076-04,317529,46892,44460,14656,114124,97368,22896,6056,3819,902,83.35,1,80.67,364421,299560,64861
2076-05,213710,41520,24712,13947,144228,177277,24988,20492,1380,1690,164.22,0,132.86,255230,405644,-150414
2076-06,363881,31036,36927,11961,98963,242451,24228,32201,3697,1425,175.21,0,80.23,394917,446731,-51814
2076-07,214078,31772,38761,5720,165728,211059,14179,13654,3976,2213,7.34,0,123.6,245850,449101,-203251
2076-08,196689,15549,38738,14484,89465,198338,27741,7169,2282,1343,7.52,1,125.36,212238,375935,-163697
2076-09,454053,23458,23503,7548,160957,72306,13871,24942,3354,1853,44.74,1,87.49,477511,303127,174384
2076-10,435509,40621,35425,12112,174707,79454,17465,15538,4278,487,26.94,1,149.17,476130,334701,141429
2076-11,182056,45985,42066,8405,176962,227715,15251,33071,1783,1676,147.15,0,124.6,228041,503470,-275429
2076-12,122323,48317,39918,12034,93205,239344,19227,28273,4089,2552,16.03,1,131.5,170640,432001,-261361
2077-01,196475,10856,32667,9814,82394,96762,14537,39098,4984,3158,69.47,0,112.41,207331,275272,-67941
2077-02,406959,37329,39824,5890,137710,137800,10320,31184,1305,3004,288.98,0,140.54,444288,362728,81560
2077-03,209114,45708,45309,13819,102083,106045,27924,37991,1779,1574,139.91,1,110.23,254822,333171,-78349
2077-04,402157,12174,36701,8925,86988,126063,17353,15771,4955,389,89.47,1,85.26,414331,291801,122530
2077-05,244443,22834,43081,11399,118915,190197,12811,18774,989,1499,235.74,0,94.98,267277,395177,-127900
2077-06,317926,15329,46786,13633,197501,170123,6700,31861,2136,1847,191.42,0,107.38,333255,466604,-133349
2077-07,229985,35851,20640,12521,111988,149367,17727,20968,2758,3991,106.01,0,87.77,265836,333211,-67375
2077-08,156274,20099,29346,11805,178522,109928,15577,17320,4651,1939,177.21,1,142.1,176373,362498,-186125
2077-09,383849,33026,33263,7404,168360,170352,22059,5461,1319,3900,231.59,1,81.41,416875,406899,9976
2077-10,404177,15610,23222,13224,187066,79174,17770,31059,2517,2292,173.3,1,105.75,419787,351515,68272
2077-11,205723,33392,36106,5372,108568,71202,28685,33578,4501,2344,-39.36,0,102.67,239115,283511,-44396
2077-12,252210,38986,35291,5705,113949,123255,22417,21548,1946,1521,95.35,1,82.8,291196,322165,-30969
2078-01,112406,20017,36090,11377,180052,244807,20985,29109,1248,3194,98.27,0,110.39,132423,522420,-389997
2078-02,224049,25908,22736,5972,152662,197073,28643,24970,2120,853,95.04,0,95.2,249957,432056,-182099
2078-03,201497,32061,43400,9507,174705,88571,22979,35204,3447,2026,101.18,1,82.93,233558,374366,-140808
2078-04,298120,33462,49204,10131,173216,183630,15644,8955,3143,1473,152.63,1,132.8,331582,440780,-109198
2078-05,447541,44367,25206,9790,102597,146452,26740,32280,4737,3836,114.56,0,117.63,491908,343065,148843
2078-06,318873,18398,47239,5431,98881,116538,18322,14143,2044,3089,161.67,0,138.42,337271,300554,36717
2078-07,272097,18001,21580,11108,80672,217779,16062,34942,1358,2841,206.49,0,121.07,290098,382143,-92045
2078-08,234730,37413,30214,8604,148234,70191,19941,9175,2957,1092,71.37,1,105.93,272143,286359,-14216
2078-09,139618,15119,39800,13438,164073,63994,12595,20750,3799,3431,-22.31,1,82.04,154737,314650,-159913
2078-10,116999,17655,34107,5856,161123,153885,25394,36581,2768,3707,62.34,1,136.81,134654,416946,-282292
2078-11,190226,41344,49454,11672,141749,243993,26476,13907,3619,1735,4.12,0,80.63,231570,487251,-255681
2078-12,269610,27276,34602,10827,196793,107059,25173,22645,2984,1962,-30.38,1,115.14,296886,397099,-100213
2079-01,128680,29108,20303,7760,128476,202373,16909,21443,3787,3979,22.85,0,93.02,157788,397264,-239476
2079-02,348991,18340,45531,8999,136119,157263,17304,18606,4179,369,38.67,0,135.85,367331,383822,-16491
2079-03,141872,33941,44064,14946,164119,214465,22691,36695,1054,1562,137.84,1,130.04,175813,496980,-321167
2079-04,107821,33904,48459,9807,93408,208214,11953,24817,1059,1663,42.79,1,100.18,141725,396658,-254933
2079-05,392866,33066,37567,10462,83866,203143,26401,9626,2652,519,100.73,0,147.1,425932,371065,54867
2079-06,223054,33273,39875,8197,133396,243751,9351,29083,3045,2262,93.56,0,81.0,256327,463653,-207326
2079-07,266408,36923,34284,10235,171607,185396,10705,6907,1715,3700,148.26,0,129.27,303331,419134,-115803
2079-08,293703,29858,47112,10359,146950,158205,18909,30843,4972,1629,84.3,1,81.82,323561,412378,-88817
2079-09,285366,25034,45076,7989,164229,192407,9457,33333,735,2698,435.1,1,122.11,310400,452491,-142091
2079-10,420129,26916,24454,5802,85045,81197,25996,16159,3425,3445,180.91,1,103.29,447045,238653,208392
2079-11,133710,26528,46548,6722,80577,146922,22103,21274,1326,371,148.86,0,110.53,160238,324146,-163908
2079-12,216440,10780,31594,13516,161905,152219,8208,38457,3154,2458,100.55,1,126.74,227220,405899,-178679
2080-01,333743,19714,30998,6251,98830,166592,23270,28867,4099,1021,100.86,0,119.81,353457,354808,-1351
2080-02,356958,37952,32503,14311,124683,187965,9476,7793,1645,3921,185.33,0,91.15,394910,376731,18179
2080-03,373222,20777,46734,9447,118059,134348,12579,12384,4543,2734,122.69,1,90.84,393999,333551,60448
2080-04,186566,41047,41132,13799,178197,229054,7080,8494,1760,3799,116.94,1,115.05,227613,477756,-250143
2080-05,391212,37895,49484,12251,196706,87462,28336,13572,4220,1454,102.81,0,103.69,429107,387811,41296
2080-06,481506,21472,25981,8637,82047,97743,26746,12652,4110,2537,105.75,0,129.29,502978,253806,249172
2080-07,366515,44281,42562,7235,104802,158084,24458,7295,4469,1294,113.53,0,104.73,410796,344436,66360
2080-08,274708,27872,44114,12333,166624,101814,19105,9435,3315,2502,66.7,1,87.08,302580,353425,-50845
2080-09,164840,20696,30415,9310,85563,248199,8169,26647,4922,2080,73.83,1,138.96,185536,408303,-222767
2080-10,413502,39927,38338,5340,104636,86869,20075,12159,3139,2390,32.64,1,94.95,453429,267417,186012
2080-11,242732,43062,47549,12265,178722,92761,10059,16025,847,2198,235.54,0,92.82,285794,357381,-71587
2080-12,497044,49446,27804,13127,111695,224061,10218,18565,4469,3482,116.9,1,132.3,546490,405470,141020
2081-01,124552,36620,21515,7513,130352,83714,6179,36670,866,2235,118.22,0,131.48,161172,285943,-124771
2081-02,236567,21272,43888,10107,197440,68107,22586,39795,1531,629,124.23,0,110.02,257839,381923,-124084
2081-03,423495,37842,44146,11324,138506,225446,6662,23040,963,2224,412.99,1,95.72,461337,449124,12213
2081-04,280544,43704,26629,7766,163305,125103,23101,27852,2895,3275,43.21,1,147.8,324248,373756,-49508
2081-05,110911,45817,29585,8348,108158,88462,12852,11503,3644,2127,16.59,0,116.31,156728,258908,-102180
2081-06,485278,39229,41750,6293,129939,247297,17605,19250,4949,2818,85.31,0,103.35,524507,462134,62373
2081-07,154994,22092,27897,10675,122298,139244,12407,22639,2785,1654,80.54,0,124.77,177086,335160,-158074
2081-08,222581,44713,26462,6791,140978,85044,6168,38259,2698,689,128.75,1,102.98,267294,303702,-36408
2081-09,341519,35734,46828,11613,119501,53127,24762,25549,2658,1935,152.36,1,98.71,377253,281380,95873
2081-10,257082,30513,46006,11573,134738,96076,12919,36436,4846,2813,60.89,1,145.44,287595,337748,-50153
2081-11,112157,13544,27551,14530,140752,69263,11159,23348,2122,1611,31.45,0,103.61,125701,286603,-160902
2081-12,126449,15181,20596,7662,140311,154482,20892,38787,1760,1755,95.12,1,107.43,141630,382730,-241100
2082-01,317014,29699,48248,5047,171253,151577,17335,12980,1592,655,211.65,0,148.78,346713,406440,-59727
2082-02,359147,44049,29260,11745,85451,122564,7175,9078,631,3183,585.03,0,97.49,403196,265273,137923
2082-03,194496,40533,20369,5624,188884,166320,25618,28440,3213,3379,135.95,1,85.47,235029,435255,-200226
2082-04,186542,35976,44262,11030,191151,241694,10682,20698,1937,3348,107.55,1,103.22,222518,519517,-296999
2082-05,240968,44880,40312,13692,101240,240879,24754,22281,1770,3487,137.29,0,110.11,285848,443158,-157310
2082-06,428589,44985,39668,10998,127930,97790,6251,19956,1705,812,313.06,0,117.8,473574,302593,170981
2082-07,437839,44003,40698,10122,126126,170444,9779,20849,3434,2927,143.18,0,103.91,481842,378018,103824
2082-08,330353,14514,38306,5642,161796,121454,18275,27688,4994,934,22.99,1,116.64,344867,373161,-28294
2082-09,482712,29134,47857,11352,102347,138840,26285,19203,1522,994,306.12,1,80.38,511846,345884,165962
2082-10,130385,34667,41270,12662,119383,194212,17501,5352,4334,2534,79.39,1,83.26,165052,390380,-225328
2082-11,397388,20212,45954,6153,90428,76686,6301,10446,4940,1987,68.07,0,116.5,417600,235968,181632
2082-12,436464,14521,24680,7570,191826,247721,7886,21495,928,2718,512.49,1,121.77,450985,501178,-50193
2083-01,493522,49330,35522,14853,86363,163877,28949,27030,1706,1942,259.49,0,85.65,542852,356594,186258
2083-02,394637,41987,42255,14350,150802,140510,16505,6589,2763,2656,180.81,0,81.96,436624,371011,65613
2083-03,256745,32174,44586,12472,111638,65012,23419,27111,1988,852,98.08,1,143.71,288919,284238,4681
2083-04,189401,34803,45542,13567,146310,166826,26809,22295,2411,2052,86.92,1,107.89,224204,421349,-197145
2083-05,173788,16048,47553,5761,142752,83653,26973,24923,3102,3677,-9.87,0,141.67,189836,331615,-141779
2083-06,394812,18987,28715,6357,89010,77605,25757,26069,3334,2695,169.13,0,98.06,413799,253513,160286
2083-07,300732,43761,33151,11554,104999,128783,7851,34929,3075,1218,62.28,0,89.72,344493,321267,23226
2083-08,124478,29654,26577,7938,123442,200900,19418,15723,1291,3047,132.53,1,133.23,154132,393998,-239866
2083-09,271399,30803,35050,5358,104798,85883,15469,39477,2254,2643,57.97,1,94.63,302202,286035,16167
2083-10,490754,32257,25529,10241,122053,52734,22948,12918,4898,3887,124.79,1,95.56,523011,246423,276588
2083-11,318665,24053,48638,9056,140622,160753,28888,18096,3174,1161,130.08,0,116.52,342718,406053,-63335
2083-12,109792,19678,48952,12272,192194,66408,20286,29076,3889,2928,-16.75,1,105.21,129470,369188,-239718
2084-01,110355,29524,25130,10590,101580,64795,17670,36411,2998,2998,28.57,0,81.62,139879,256176,-116297
2084-02,305163,15500,39348,8739,101628,155800,12288,34265,2166,1316,157.11,0,120.84,320663,352068,-31405
2084-03,220005,45788,37427,9848,140349,141400,25910,7207,1912,2709,60.28,1,119.68,265793,362141,-96348
2084-04,152142,16769,41591,14555,194678,111687,10491,6828,3626,1827,143.77,1,135.23,168911,379830,-210919
2084-05,385800,24994,24360,6831,91351,157647,21465,29786,2801,1974,154.1,0,100.86,410794,331440,79354
2084-06,430955,38610,40175,6134,136124,93763,10588,30002,3467,797,114.61,0,126.37,469565,316786,152779
2084-07,168358,11399,22760,10503,107694,63208,25372,30506,1108,3074,131.67,0,108.75,179757,260043,-80286
2084-08,458783,25492,24116,7053,93244,122027,27024,6764,644,3846,792.39,1,98.79,484275,280228,204047
2084-09,480436,14669,45013,12771,196165,139617,25840,29055,1843,2765,191.84,1,88.88,495105,448461,46644
2084-10,153082,14433,44098,5078,174544,229061,15895,19089,4109,2686,20.11,1,112.58,167515,487765,-320250
2084-11,409498,14045,48739,5765,90524,242889,14478,16091,2871,3191,190.23,0,114.96,423543,418486,5057
2084-12,209331,25072,45213,12705,119479,81001,13160,18592,860,2602,212.23,1,129.65,234403,290150,-55747
2085-01,193316,30181,20648,5638,86634,169540,27880,6949,2579,1099,107.02,0,83.37,223497,317289,-93792
2085-02,424309,24737,22154,12807,163352,67960,14164,5970,2368,1825,200.61,0,91.89,449046,286407,162639
2085-03,142186,25347,48508,6358,158447,214976,14149,15900,1494,2315,116.15,1,142.9,167533,458338,-290805
2085-04,178814,32194,30634,5866,113511,243385,17890,39364,3451,1698,75.88,1,91.02,211008,450650,-239642
2085-05,195125,21553,40401,10664,125113,202291,7864,26524,3175,504,-54.84,0,130.76,216678,412857,-196179
2085-06,235484,25659,21660,5800,178732,135713,26845,6581,2274,3047,138.55,0,101.87,261143,375331,-114188
2085-07,122245,35025,26632,10717,111008,124249,10417,36822,1903,2588,46.03,0,136.56,157270,319845,-162575
2085-08,229308,40909,46087,11123,170347,117459,19354,7415,2401,2280,44.47,1,107.24,270217,371785,-101568
2085-09,306982,10709,26319,9070,83925,225771,14816,33144,3596,2540,194.58,1,96.16,317691,393045,-75354
2085-10,354869,45634,46908,5761,146661,109334,29565,14388,3212,2243,100.32,1,86.19,400503,352617,47886
2085-11,167557,29649,46485,6582,159615,134939,14682,29035,912,3087,146.28,0,131.84,197206,391338,-194132
2085-12,225161,46121,21529,13488,124211,94290,10600,31230,3136,3893,114.9,1,80.73,271282,295348,-24066
2086-01,219369,11899,35286,13475,184665,111613,7362,14406,2853,1306,119.1,0,120.07,231268,366807,-135539
2086-02,430297,49038,26765,12373,197909,165733,21606,23020,3435,1277,72.24,0,80.51,479335,447406,31929
2086-03,369318,35938,47978,12015,170641,164245,18504,37881,3964,3994,60.22,1,124.33,405256,451264,-46008
2086-04,424797,28028,42919,8349,80073,240964,12274,6337,1940,2750,187.66,1,146.69,452825,390916,61909
2086-05,136447,47799,36712,12100,187921,246996,9595,30758,2723,2204,-9.26,0,99.8,184246,524082,-339836
2086-06,274257,26762,24378,6820,132421,98304,16956,18413,3982,3710,60.07,0,117.91,301019,297292,3727
2086-07,290336,21888,32200,10444,174811,157130,12587,34022,1930,3956,183.62,0,140.34,312224,421194,-108970
2086-08,200542,40123,30315,11906,97637,77121,27574,19346,1533,2846,183.07,1,125.43,240665,263899,-23234
2086-09,406528,36919,26061,11872,188738,141504,13603,23579,4663,1041,29.11,1,139.2,443447,405357,38090
2086-10,323604,21813,23091,8231,85828,106316,29294,16747,4216,3700,137.89,1,144.2,345417,269507,75910
2086-11,163357,17173,21854,8262,181374,189512,14084,8302,1550,1663,153.08,0,109.92,180530,423388,-242858
2086-12,252617,40012,42622,12757,82265,229438,24711,37616,4143,2247,97.42,1,88.3,292629,429409,-136780
2087-01,297474,20588,38304,12308,142624,154955,6700,32304,3998,1997,112.83,0,120.5,318062,387195,-69133
2087-02,347127,14097,44344,9210,101496,164480,7206,23389,2605,512,143.89,0,119.69,361224,350125,11099
2087-03,441352,27469,40631,14377,165210,125311,23591,11634,2960,499,118.03,1,133.11,468821,380754,88067
2087-04,146543,46031,42656,9770,165742,199333,8106,32905,3852,852,18.73,1,141.32,192574,458512,-265938
2087-05,273950,36835,23969,8986,120814,179803,29537,10822,4185,2055,90.32,0,121.7,310785,373931,-63146
2087-06,140444,10284,49808,6977,110246,208600,11743,12714,720,3617,208.42,0,106.66,150728,400088,-249360
2087-07,347072,48374,33777,7720,139129,219921,15425,17774,4503,3833,92.58,0,128.82,395446,433746,-38300
2087-08,205792,22291,38488,14913,187717,185401,26247,6873,2011,3757,48.03,1,131.32,228083,459639,-231556
2087-09,404759,11052,35348,9644,198167,204638,11043,7394,635,3582,575.39,1,95.25,415811,466234,-50423
2087-10,154713,29728,25160,12167,174603,94853,24669,26575,4864,3592,-59.59,1,128.98,184441,358027,-173586
2087-11,383270,45237,45076,6569,176028,248253,8838,37584,1353,3529,210.45,0,86.94,428507,522348,-93841
2087-12,457598,46343,31534,8964,118488,155064,25052,32189,1445,1653,266.69,1,109.19,503941,371291,132650
2088-01,471489,45162,39186,14090,188893,246051,16221,23129,1175,3539,414.4,0,97.21,516651,527570,-10919
2088-02,357660,46882,20357,6709,134985,118169,10374,15235,2210,2530,130.91,0,116.2,404542,305829,98713
2088-03,118110,40235,23098,12052,174929,222065,17865,11422,670,2752,218.28,1,108.13,158345,461431,-303086
2088-04,106437,49835,21184,13455,183909,212980,12339,10074,4884,3339,152.36,1,148.44,156272,453941,-297669
2088-05,223097,32436,35799,6977,163615,57465,18675,19945,1304,2138,169.68,0,98.45,255533,302476,-46943
2088-06,252093,13317,39641,9563,119540,244825,11362,29011,4797,465,44.42,0,86.05,265410,453942,-188532
2088-07,181113,13043,40259,8761,116390,121840,13765,10988,3834,818,104.33,0,134.26,194156,312003,-117847
2088-08,188031,42315,44735,10005,127888,157218,28498,28381,2520,2991,55.07,1,114.16,230346,396725,-166379
2088-09,195954,35784,31286,9334,129359,118091,27134,25195,2952,2997,-53.24,1,131.36,231738,340399,-108661
2088-10,171554,28008,44068,5949,80228,213538,28455,31543,2574,2876,93.2,1,86.51,199562,403781,-204219
2088-11,288599,44337,38611,14085,158170,194973,27386,11870,988,3673,341.77,0,101.65,332936,445095,-112159
2088-12,160215,40063,34268,10339,99291,94470,22723,25985,2791,1058,54.84,1,89.0,200278,287076,-86798
2089-01,218140,14488,29790,11972,183041,216686,11945,20531,3242,3900,67.65,0,100.28,232628,473965,-241337
2089-02,378967,37858,22623,12704,167459,81001,23507,36132,4273,2273,77.2,0,86.54,416825,343426,73399
2089-03,131135,28422,40586,14184,182925,224508,16806,19604,3370,990,61.21,1,142.29,159557,498613,-339056
2089-04,321349,14978,46899,12742,165648,144561,24988,14272,2660,603,97.66,1,123.66,336327,409110,-72783
2089-05,318918,12697,41891,9006,181838,105531,19119,24246,4277,2566,59.2,0,121.47,331615,381631,-50016
2089-06,363086,47461,44916,10645,159247,170046,23573,29426,2173,587,226.39,0,90.77,410547,437853,-27306
2089-07,121654,35235,29276,6611,179182,193909,24246,19223,3610,3365,42.52,0,88.88,156889,452447,-295558
2089-08,197167,48166,40324,6303,140650,202833,17564,39170,1537,1494,45.64,1,117.78,245333,446844,-201511
2089-09,290798,26465,39620,5076,124085,92608,11735,29455,4425,596,24.8,1,145.27,317263,302579,14684
2089-10,440193,30955,38820,14486,146521,79922,25330,27185,2198,605,141.16,1,100.81,471148,332264,138884
2089-11,402789,27906,25749,12025,164626,78838,11027,9607,2030,3522,241.58,0,122.39,430695,301872,128823
2089-12,381066,42574,30979,12124,101366,98489,18089,34819,4797,485,18.05,1,111.32,423640,295866,127774
2090-01,286898,11627,40847,7780,103965,141349,13500,23928,1138,725,310.11,0,119.37,298525,331369,-32844
2090-02,363921,26210,47809,10356,131389,144203,7566,36903,1612,1544,208.49,0,88.5,390131,378226,11905
2090-03,135276,19464,43470,11545,130816,146678,26184,32537,2958,2478,64.59,1,100.46,154740,391230,-236490
2090-04,324793,28358,34822,14694,132254,123754,14301,13740,4323,2686,85.28,1,132.79,353151,333565,19586
2090-05,415599,26269,24467,7660,97504,114272,16521,37017,3051,3377,183.04,0,92.57,441868,297441,144427
2090-06,227641,14336,49502,14861,143681,131923,29317,11645,1024,1318,298.61,0,112.38,241977,380929,-138952
2090-07,284065,46593,23292,14955,94562,129327,24476,7856,2434,2410,124.73,0,89.57,330658,294468,36190
2090-08,223243,43482,40054,12873,143129,64638,10158,25939,3169,1119,42.22,1,81.59,266725,296791,-30066
2090-09,194536,19668,20984,10085,114537,244485,24939,5480,3439,3250,35.82,1,124.46,214204,420510,-206306
2090-10,113123,30300,47471,10704,126144,171510,14382,17456,3967,3457,-42.49,1,108.43,143423,387667,-244244
2090-11,494899,39740,29142,13961,101215,120730,11518,25171,4209,2105,157.2,0,85.53,534639,301737,232902
2090-12,153125,36275,47156,8642,98135,175294,10172,39701,2792,1423,64.98,1,134.54,189400,379100,-189700
2091-01,216130,32337,33142,12138,105078,220150,7512,20443,3102,3347,113.48,0,86.41,248467,398463,-149996
2091-02,356052,47803,22883,11766,88254,173006,8138,26840,4631,2607,-22.78,0,136.93,403855,330887,72968
2091-03,395779,23694,32919,9182,131632,121231,28459,10873,2055,713,125.0,1,141.96,419473,334296,85177
2091-04,237221,31449,28499,9744,186971,171050,29687,24282,4645,2559,121.02,1,90.67,268670,450233,-181563
2091-05,315979,19838,47918,7707,194402,193541,10699,10182,4177,3382,31.16,0,94.91,335817,464449,-128632
2091-06,464582,38025,24485,6325,122042,129294,9508,39653,2326,1836,84.36,0,139.79,502607,331307,171300
2091-07,428091,49511,49365,9673,163696,153199,14953,14109,2763,832,206.23,0,89.64,477602,404995,72607
2091-08,306944,10515,46921,14479,123711,54831,15872,32627,2428,503,121.39,1,119.21,317459,288441,29018
2091-09,492001,20631,35917,8144,184247,244332,18301,15198,1551,638,368.37,1,137.78,512632,506139,6493
2091-10,196976,21367,34858,9901,195649,129452,27096,10528,1004,648,180.43,1,145.89,218343,407484,-189141
2091-11,241245,11862,23450,9010,104343,84574,8445,35778,737,3451,334.38,0,133.39,253107,265600,-12493
2091-12,226799,45264,24132,9463,97218,181922,16687,33781,3921,3734,63.22,1,81.52,272063,363203,-91140
2092-01,215436,21689,23822,9131,100774,117071,14049,30096,4864,2065,46.47,0,121.41,237125,294943,-57818
2092-02,297356,11677,39576,6576,126181,109880,13411,30713,1775,2254,206.11,0,82.18,309033,326337,-17304
2092-03,171796,40546,23442,6277,98265,68387,27312,7173,2019,1598,66.53,1,141.15,212342,230856,-18514
2092-04,136877,26066,43365,13467,166966,132318,6475,30050,666,927,217.39,1,105.26,162943,392641,-229698
2092-05,454742,35085,25509,5817,81866,51435,17158,32414,2015,3301,161.85,0,99.75,489827,214199,275628
2092-06,260044,42137,41664,12873,181214,50775,17720,39139,4854,636,36.72,0,143.41,302181,343385,-41204
2092-07,326570,23333,26825,7234,176784,174421,27376,6155,627,2041,497.47,0,119.67,349903,418795,-68892
2092-08,458109,40867,44701,12230,128652,89627,7167,27695,1840,331,206.78,1,111.79,498976,310072,188904
2092-09,102679,43701,23343,5683,91937,202046,27164,38513,504,3990,210.07,1,136.43,146380,388686,-242306
2092-10,323721,12469,37070,10714,134449,128585,27235,18138,4841,2966,94.85,1,123.97,336190,356191,-20001
2092-11,446587,38168,25330,11847,85302,233615,20472,34426,4690,2027,14.52,0,95.0,484755,410992,73763
2092-12,390165,13390,20123,13577,94258,72861,19544,28762,1120,2005,348.62,1,143.3,403555,249125,154430
2093-01,296800,13562,33932,8264,187295,228977,22794,24087,4840,2153,182.82,0,112.92,310362,505349,-194987
2093-02,269456,25612,49432,11618,149304,69787,14502,9320,3972,3897,42.77,0,145.62,295068,303963,-8895
2093-03,253953,24655,29490,13394,137763,171739,20767,20921,2482,2093,151.57,1,113.05,278608,394074,-115466
2093-04,209929,28769,38862,12035,100648,242397,10323,38371,2507,3228,38.49,1,84.61,238698,442636,-203938
